#FORM2
[npc_list]
天墉城 : ({ 逍遥仙, 无极散人, 天机老人, 普华天尊, 诛魔真人, 红娘, 拍卖师, 帮派使者, 白邦芒, 妙手道人, 商会会长, 宁彩神, 赤灵尊神, 帮派管理员, 状元王中王, 守护天神, 百晓通, 北斗星使, 鬼道子, 夜行人, 千面怪, 大胡子, 无名剑客, 林老汉, 茅山道士, 游方术士, 神算子, 蒙面, 辛仁皑, 南极仙翁, 董老头 })
揽仙镇 : ({ 多闻道人, 渺渺道人, 华阳真人, 黄仨儿, 乐善施, 莲花姑娘 })
无名小镇 : ({ 善财童子, 仙界神捕, 南华真人, 玉鉴上人, 玉泉真人, 清微真人 })
东海渔村 : ({ 宋辛哲, 柳如尘, 玉真子, 天玄老人 })
巧手坊 : ({ 晶晶儿, 管神工, 厉巧手, 精精儿 })
南北杂货铺 : ({ 屠娇娇 })
总督衙门 : ({ 夏总兵, 张司徒 })
风月谷 : ({ 苏苏, 朱雀, 月老 })
无名客栈 : ({ 无名客栈小二, 无名客栈老板 })
无名武器店 : ({ 无名武器店老板, 驭剑仙 })
无名布庄 : ({ 鲁工匠, 无名布庄老板 })
悟云观 : ({ 通灵道人 })
仁和布庄 : ({ 贾仁和 })
富甲钱庄 : ({ 钱大富 })
喜来客栈 : ({ 冯喜来 })
回春堂药铺 : ({ 杜卜思 })
神勇兵器铺 : ({ 段铁心 })
威震镖局 : ({ 杨镖头 })
官府 : ({ 贾师爷 })
揽仙客栈 : ({ 赵老板 })
威扬武器店 : ({ 张老板 })
万全药铺 : ({ 王老板 })
永合杂货铺 : ({ 贾老板 })
天下钱庄 : ({ 钱老板 })
天锦布庄 : ({ 卜老板 })
无名钱庄 : ({ 无名钱庄老板 })
无名杂货店 : ({ 无名杂货店老板 })
无名药铺 : ({ 无名药铺老板 })
药店 : ({ 药店老板 })
钱庄 : ({ 钱庄老板 })
客栈 : ({ 客栈老板 })
百花谷一 : ({ 何仙姑 })
百花谷二 : ({ 张果老 })
百花谷三 : ({ 韩湘子 })
百花谷四 : ({ 蓝采和 })
百花谷五 : ({ 吕洞宾 })
百花谷六 : ({ 汉钟离 })
百花谷七 : ({ 铁拐李 })
蓬莱岛 : ({ 曹国舅 })
