#任务名称,       任务描述
新手指导:        任务介绍：按照系统的帮助和指引完成任务，很快就能够熟悉地图并得到奖励。

传递口信:        任务介绍：帮助#R揽仙镇客栈#n的#Y小二哥#n捎带口信。

收集宠物:        任务介绍：捕捉到#P董老头#P需要的宠交给他，就能够得到丰厚的报酬。

为民除暴:        任务介绍：协助官府缉拿危害百姓的强盗和土匪。

降妖:            任务介绍：协助通灵道人降伏危害人间的妖怪。

收集材料:        任务介绍：收集#Y念心道人#n需要的材料交给他，杀死怪物就有机会获得相应的材料。

30环连环任务:    任务介绍：玩家帮助#R天墉城#n的#Y店小二#n做些事情，可因此获得金钱奖励。（此任务30环为一轮，下线后消失，#R位列仙班（使用道具套餐卡可获得此资格）#n或拥有#R跑环记录卡#n则任务下线不消失。）

60环连环任务:    任务介绍：玩家帮助#R天墉城#n威震镖局的#Y杨镖头#n做些事情，可因此获得金钱奖励。（此任务60环为一轮，下线后消失，#R位列仙班（使用道具套餐卡可获得此资格）#n或拥有#R跑环记录卡#n则任务下线不消失。）

90环连环任务:    任务介绍：玩家帮助#R东海渔村#n的#Y宋辛哲#n做些事情，可因此获得较为丰厚的金钱奖励。（此任务90环为一轮，下线后消失，#R位列仙班（使用道具套餐卡可获得此资格）#n或拥有#R跑环记录卡#n则任务下线不消失。）

寻找宝藏:        任务介绍：按照藏宝图的指引寻找宝藏。（换线或下线后任务消失）

双倍奖励时间:    任务介绍：在双倍时间内杀怪可以获得两倍奖励。

三倍奖励时间:    任务介绍：在三倍奖励时间内杀怪可以获得三倍奖励。

驱魔香时间:      任务介绍：使用驱魔香能够驱散低于玩家等级的妖魔。

强力驱魔香时间:  任务介绍：使用后在1个小时内具有驱妖避魔功效的神奇道具，最高可以驱避高于自身等级10级的怪物。（强力驱魔香效果下线不消失）

惊妖术时间:      任务介绍：在半个小时内，遇怪机率增加。

送宠任务:        任务介绍：帮助莲花姑娘把宠物送给他们的主人。（有宠物在队伍中时，驱魔香无效；本任务离队或转移队长时会消失）

查看地图任务:    任务介绍：帮助师父到多闻道人那里取回中洲大地图。

坐牢:            你犯罪了！你需要在线待足规定时间才可以离开这里。也可以让好友到官府的监狱里向牢头支付赎金离开。

天王寻珠:        任务介绍：游戏中遇到魔礼寿，帮他回天墉城的找人任务。（离队后任务消失）

千面怪:          帮千面怪寻找材料的任务。（下线或者换线后任务消失）

宝玉寄情:        任务介绍：游戏中救助了林老汉，所引发出来的系列任务。

高级宝藏:        任务介绍：在游戏中根据高级藏宝图进行寻宝，所遇到的连环宝藏。（换线或下线后任务消失）

超级宝藏:        任务介绍：在游戏中根据超级藏宝图进行寻宝。（下线后任务不消失）

五色灵珠:        任务介绍：游戏中在天墉城随机遇到灵兽异人，帮助神兽异人的任务。（在找到灵兽异人前离队，任务消失）

妖魔道:          任务介绍：相传恶灵鬼王每一千年可重生一次，回到世间作恶，玩家历经重重苦难将恶灵鬼王消灭。

沿途追击:        任务介绍：玩家追捕怪物的任务。

出师任务:        任务介绍：徒弟的等级达到出师条件后，师徒二人共同完成的任务。

研发任务:        任务介绍：帮助悟天道人寻找材料进行技能研发的任务。

春节活动:        任务介绍：赶年兽，孵灵兽，热热闹闹过大年。

伏魔任务:            任务介绍：发现道行高深的妖邪现身后，你协助散仙陆压真人伏魔以正道。

游戏指引:        任务介绍：按照黄仨儿的指引完成任务，可以更好的熟悉游戏并得到奖励。

妖魔道-妖魔当道: 任务介绍：相传恶灵鬼王每一千年可重生一次，回到世间作恶，玩家历经重重苦难将恶灵鬼王消灭。

妖魔道-探寻真相: 任务介绍：相传恶灵鬼王每一千年可重生一次，回到世间作恶，玩家历经重重苦难将恶灵鬼王消灭。

妖魔道-除魔卫道: 任务介绍：相传恶灵鬼王每一千年可重生一次，回到世间作恶，玩家历经重重苦难将恶灵鬼王消灭。

测运气:          任务介绍：接受门派师尊交办的一些事情，完成后会获得嘉奖，#R位列仙班玩家每天完成前30个任务可以得到额外金钱奖励#n。

五行竞猜:        任务介绍：在问道过程中，玩家可以通过特定活动NPC进行竞猜活动。

修行:            任务介绍：修炼艰辛，到达一定境界便会难于精进。有鉴于此，玉虚真人命众灵神指点练道者修行。
修行任务（队长）:            任务介绍：修炼艰辛，到达一定境界便会难于精进。有鉴于此，玉虚真人命众灵神指点练道者修行。

卦象显示:        任务介绍：神算子演算先天神卦，以知未来吉凶。

国庆师徒送大礼:        任务介绍：国庆期间，在游戏中带徒弟升级超过50级，可以得到由系统送出的额外奖励。（请于20日之前领取）

神木鼎:        任务介绍：使用神木鼎后有一定几率得到怪物魂魄凝成的变身卡片。持续时间#R60#n分钟，或在耐久度耗尽后，道具效果消失。

荣誉之星:        任务介绍：带领1-79级且比自己等级低的玩家升级可获得荣誉值。

出现叛徒:        任务介绍：僵尸军团中出现叛徒，出卖了自己的同伙（本任务离队或转移队长时会消失）。

逃兵任务:        任务介绍：追杀僵尸大军中的逃兵（本任务离队或转移队长时会消失）。

挑战帮派名人堂:  任务介绍：帮派名人堂共四七二十八关，由二十八星宿镇守，必须依次挑战。挑战每个关卡时都必须5人组队，否则不可挑战。（离开帮派名人堂后任务消失。）

宠物双倍奖励时间:       任务介绍：在宠物双倍奖励时间内杀怪，宠物可以获得双倍奖励。

兰若寺:       任务介绍：千年树精为讨好黑山老妖欲将侍女小倩送与其做妾，但小倩和书生采臣相爱在先，故宁死不从。玩家消灭千年树精和黑山老妖，使有情人终成眷属。

居所活动:       任务介绍：玩家居所触发的随机任务，夫妻共同完成后可以增进双方感情。
答题系统:       任务介绍：你可以在#Y天墉城考官#n那里获得一轮答题机会，答对了还有奖品送给你。

无量心经:       任务介绍：你使用了无量心经来记录经验心得。

萝卜桃子大收集:       任务介绍：化妆舞会任务，收集#R萝卜、桃子#n后交给#P千面怪#P即可获得奖励。

奥运知识问答:  你可以在#Y奥运知识考官#n那里获得一轮答题机会，答对了还有奖品送给你。

宠物飞升任务:  任务介绍：经过主人的引导，宠物可以飞升而达到新的境界，突破等级限制。

在线送经验 :  任务介绍：天地灵气蕴集于中洲大陆之时，所有在线玩家都可以自动吸收灵气，吸取到灵气后可到#Z揽仙镇(61,178)#Z找NPC#P渺渺道人#P换取大量的经验。#r活动期间，在线时间越长所得经验越多。#r请于活动结束后的#R24#n小时内兑换经验，否则灵气将被自动清除。

修法任务  : 任务介绍：帮助多宝道人前去降伏抢夺法宝的妖魔精怪。

仙界通缉:     任务介绍：仙界派下通缉令，诛杀降临到人间的妖邪至尊。

天劫任务游戏指引  : 任务介绍：按照问道小子的指引完成任务，可以更好的熟悉游戏并得到奖励。#R(该任务若在角色升至135级时仍未完成，则任务自动消失)#n

领取徒弟资助  : 任务介绍：作为徒弟，你可以获得一些经验、潜能和金钱的资助，以后每10级都可以领取一次。

抽取师徒奖励  : 任务介绍：邀友问道，轻松得奖。作为师父，以后你的徒弟每升10级，你都可以抽取奖励，运气好可以得到生肖兽奖励哦。

助人为乐  : 任务介绍：#R天墉城#n、#R云霄宫#n和#R南天门#n中每天都有不少人需要帮忙，帮助他们后可以获得#P白邦芒#P的犒赏。

家具材料任务:       任务介绍：收集#Y鲁工匠#n需要的物品，来交换打造家具所需要的材料。

天降大任  : 任务介绍：天将降大任于斯人也，必先苦其心志，劳其筋骨，饿其体肤，空乏其身。

守护神试炼  : 任务介绍：守护神镇守一方，对于道法之妙有着独特的领悟，受其指点一番，于修行大有助益。

拯救驯鹿行动  : 任务介绍：驯鹿被#P驯鹿绑匪#P绑架，#Z揽仙镇#Z的#P驯鹿王#P请求玩家帮助解救驯鹿。

幸运家具  :  任务介绍：你使用了幸运家具，获得了幸运的祝福。你可以使用#R还原丹#n清除该任务。

友好度任务  :  任务介绍：你领取了家具友好度任务。当夫妻二人获得友好度提升时，提升效果加倍。通过友好度任务、道具获得的友好度提升不会受到该效果的影响。

指引任务  : 任务介绍：欢迎来到问道的世界！通过指引任务，将逐步熟悉《问道》中的主要玩法，每完成一步，就会获得大量奖励。

初来乍到  : 任务介绍：你进入了问道的世界，出生在一个叫#Z揽仙镇#Z的小镇子里，现在去找村子里的人学习相关知识吧。

获得宠物  : 任务介绍：行走江湖，难免孤单。寻找一只好宠物，可以保证自己的安全，也可以在漫长的修道生涯里不至于太过寂寞。

提升能力  : 任务介绍：使用#RALT+H#n键或点击屏幕右下方金色的问号按钮，可以打开帮助界面。选择#R人物介绍#n，查看各种属性的意义，并选择属性的加点。

小试身手  : 任务介绍：你得到了一把武器，正好可以用来小试身手，到村外试试这把武器是否真的趁手吧！

送药  : 任务介绍：进行战斗离不开药品的帮助，#P莲花姑娘#P告诉你可以寻求王老板的帮忙。

调查劫匪  : 任务介绍：钱老板在家里被人抢劫，这事比较奇怪，帮助钱老板打听关于劫匪的线索。此任务需要战斗。#Y建议7级以上，完成了装备系列任务后的玩家，推荐组队完成。#n

学习道术  : 任务介绍：你身有学习道术的潜质，通过#P钱老板#P的介绍，可以向#P乐善施#P学习一种道术。

新手礼包  : 任务介绍：告别新手阶段，领取元宝奖励。

全局双倍奖励时间 : 在全局双倍时间内杀怪可以获得两倍奖励，若同时拥有全局双倍时间和双倍（三倍）时间，所得奖励皆受两者影响。（注：本任务如遇系统固定的全局双倍奖励时间则顺延。）

重返问道奖励  : 任务介绍：欢迎重返问道！我们为你准备了一份好礼！

南荒巫术普通卦  : 任务介绍：神奇的南荒巫术可以让你在对应的练功区只遇到想遇到的怪物。

南荒巫术特殊卦  : 神奇的南荒巫术可以让你提高获得特殊变身卡的几率。

虎狼争霸  : 任务介绍：你参加了化妆舞会"虎狼争霸"游戏，抓住更多兔子，额外活动奖励越高。

悬赏令  : 任务介绍：协助#R无名小镇#n的#P仙界神捕#P追拿仙界逃亡人间的#Y仙界叛逆#n，任务完成后可以向#Y仙界神捕#n领取奖赏。

神秘大礼  : 每天上线后，在线一段时间就会得到一份神秘大礼。（下线后时间清零）

挑战幻仙塔  : 任务介绍：打开地图道具，可以选择一条从入口到出口的通关线路，并将幻卡放入线路上的房间地图中，即可进入该地图中。进入地图后，必须完成该幻卡对应的任务，才可以进入下一个地图。完成预定的层数后才可以获得奖励！

安全知识问答  : 你在#R揽仙镇#n的#Y安全大使#n那里获得一组安全知识问答的机会，答对了会有奖励送给你。

通天塔  : 凡诚心向道者，皆可在通天塔内潜心修炼，领悟天道。

八仙梦境 : 在八仙的梦境之中，你将紧随八仙的脚步，体验属于八仙的传奇故事。

神仙附体  : 你被#Y神仙附体#n了！在附体时间内，将获得神仙的眷顾，获得特殊的能力。

提前领取双倍时间  : 你使用了定时领取双倍功能，在预定时间结束后，双倍时间开始计时并生效。

问道引路人  : #Y门派童子#n正在登记#R问道引路人#n信息。谁推荐你进入游戏，就填写他的角色名字（#R注意：不是帐号哦！#n），如果没有人推荐你，你也可以填写为自己的名字。填写引路人后，在固定等级你可以获得额外奖励，还可以为你的引路人积累引路人积分。

圈圈乐活动  : 每天的固定时间里，在一些地上会随机刷新大量的圈圈，踩中则会中奖。大家可以比赛看谁踩得多。

力克双煞  : 异界煞星妄图将被封印在魔境中的众妖魔释放到人间，中洲大陆各路仙家侠士奔赴魔境降妖除魔。#r（本任务每日只可完成一次）

荡除妖将  : 异界煞星妄图将被封印在魔境中的众妖魔释放到人间，中洲大陆各路仙家侠士奔赴魔境降妖除魔。#r（本任务每日只可完成一次）

缤纷好礼大派送  : 天神生辰，普天同贺。特举行缤纷好礼大派送活动。凡活动时间内在线#R10#n分钟，均可得到一份奖励。（请在下次活动开始前及时领取奖励！）

组队指引  : 本任务为组队相关的指引任务，通过完成此任务，可以对组队的操作方法有一定的了解。

战斗指引任务  : 学习战斗中常用的操作指令。

引路人换积分  : 推荐好友注册帐号玩问道，其首次进入游戏时在门派童子处填写你为引路人，你就能获得引路人积分。其参与各种问道活动也可以增加你的引路人积分，积累引路人积分可以在#P问道引路人#P处兑换奖励！

征讨五妖王  : 任务介绍：曾被封印的五个妖王纠集众多魔兽逃往五龙窟，意欲在人间兴风作浪，协助#Y慧锦使者#n打败妖王将获得大量的#R经验#n或#R道行#n奖励。本任务需独立领取和提交，但与怪物战斗时单人或组队均可，怪物数量与队伍人数相关，怪物等级与队伍中#R等级最高的玩家#n相同。

诛杀邪神  : 诛杀邪神是个一追到底的杀怪活动，诛杀的速度要够快，获得的奖励才够丰厚。

仙魔争夺战活动  : 任务介绍：仙魔争夺战活动特殊任务。帮助仙界搜集物资，抵抗叛乱的叛逆与入侵的魔界妖孽。每完成1轮10次任务，可以获得奖励。

降服小妖  : 异界妖王妄图将被封印在魔境中的众妖魔释放到人间，中洲大陆各路仙家侠士奔赴魔境降妖除魔。#r（本任务每日只可完成一次）

降灭妖王  : 异界妖王妄图将被封印在魔境中的众妖魔释放到人间，中洲大陆各路仙家侠士奔赴魔境降妖除魔。#r（本任务每日只可完成一次）

元旦之送喜帖  : 仙界有两位神仙今日喜结连理，可是需要宴请的宾客太多，需要大家帮忙送喜帖，让他们及时赶到。任务完成找#P问道活动大使#P进行其他任务
元旦之护送礼物  : 仙界有两位神仙今日喜结连理，客人们送来了许多礼物，需要大家帮忙护送到#P问道活动大使#P这里来，千万不要弄丢了哦。
元旦之神仙抢亲  : 到指定地点附近到处转转，把前来抢亲的神仙们击退。每天可以完成本任务10次。任务完成找#P问道活动大使#P进行其他任务

娃娃拜师  : 任务介绍：娃娃可以从五大门派的师尊处学到战斗技巧，但一个娃娃只能拜入一个门派。

学习任务  : 娃娃通过学习，提升历练技能与战斗技能。每30分钟为一轮，获得点数。需要玩家在线。

历练任务  : 娃娃通过历练，可以获得历练点报酬，历练点可以找#P历练物资官#P兑换奖励。每30分钟为一轮，计算报酬。需要玩家在线。

娃娃领回  : 当夫妻双方的婚姻走到尽头，总有一些娃娃的问题需要解决。

养育任务  : 帮助你的孩子完成任务，可以增加两代人之间的亲密。（取消任务会降低亲密）

欢庆寒假  : 大家成功的将#Y雪人#n从#Y冰雪魔王#n的手中解救了出来，现在是狂欢时间。

召集宠物  : 四处召集宠物，壮大寒假庆典队伍。

雪国的宝藏  : 为了今年冬天能够降雪，探寻雪国宝藏的秘密。

雪神的宝藏  : 经过一番寻觅，终于得到了雪神宝藏的线索。

仙魔转换  : 飞升之后，若想转换仙魔，可以找#P鬼道子#P帮忙。#R(中途若有异样，可至#n#P鬼道子#P#R处放弃任务)#n

召回好友奖励  : 感谢你将老朋友召回问道！我们为你准备了一份好礼！

十绝阵  : 任务介绍：法道无为乃修行之本。历练各种自然道法更能精进你的修为。
十绝阵（队长）  : 任务介绍：法道无为乃修行之本。历练各种自然道法更能精进你的修为。

重选第二门派  : 修行之路漫漫，难免有错误的选择。亡羊补牢，为时未晚。这是一次#R重新选择第二门派技能#n的机会（#R已经学过的第二门派技能会清除#n）。

庆典寻宝  : 问道四周年活动庆典，宝藏都被藏到哪里去了呢？扛上锄头去找找吧（本任务进行下线或换线等操作会消失）。

庆典寻人  : 问道四周年活动庆典，你能找到这些故事的主人公吗？（#R本任务下线或换线都会消失#n）

宠物三倍奖励时间  : 在宠物三倍奖励时间内杀怪，宠物可以获得三倍奖励。

帮派活动之圈圈乐  : 每天的固定时间里，在帮派总坛会随机刷新大量的圈圈，踩中则会中奖。大家可以比赛看谁踩得多。

自动摆摊  : 玩家在自动摆摊状态下可以用摊位NPC来代替自身的摆摊，并且支持远程上货功能，离线后摊位不消失。

仙山逐日  : 任务介绍：上古东皇九子再次出现，为祸世人，修道之人应斩妖除魔，为民造福。

遍访高人  : 世俗之中，高人无数，若诚心修道，可一一拜访，然则一路妖魔潜伏，道友如能力克艰险，将获益良多。

记者任务  : 拥有记者任务的角色可以在比赛时间内登录跨服区组，记者不可以参与任何战斗。

问道辞典之选拔赛 : #R每周日19：00-19：10#n举行答题活动#R问道辞典之选拔赛#n；表现优异者可以继续第二阶段的挑战赛，但到19：15尚未答完的将不可参加。

问道辞典之挑战赛 : 在选拔赛中表现优异的选手可以在#R19：20-19：30#n之间继续答题，一展身手。#R注意#n：若结束答题的时间超过19：30，则不计入名次，但仍可获得道行奖励。

恶作剧 : 你被恶作剧了，在接下来的时间里，将恶作剧传给别人吧！哈哈！

功能卷轴・易筋改气 : 魔道中流传的法门，使用后可以短期内提高自身的某项能力。

功能卷轴・乐于助人 : 你获得了#Y白邦芒#n的信任。

功能卷轴・神工砺兵 : 你获知了神工巧匠的心得，可以在进行装备相关操作时节省掉金钱的消耗。

任务卷轴・拜师 : 完成相应目标后可以获得奖励。
任务卷轴・结婚 : 完成相应目标后可以获得奖励。
任务卷轴・结拜 : 完成相应目标后可以获得奖励。
任务卷轴・采购 : 完成相应目标后可以获得奖励。
任务卷轴・捉宠 : 完成相应目标后可以获得奖励。
任务卷轴・摆摊 : 完成相应目标后可以获得奖励。
任务卷轴・钱庄 : 完成相应目标后可以获得奖励。
任务卷轴・切磋 : 完成相应目标后可以获得奖励。
任务卷轴・炼丹 : 完成相应目标后可以获得奖励。
任务卷轴・绑定 : 完成相应目标后可以获得奖励。
任务卷轴・加锁 : 完成相应目标后可以获得奖励。
任务卷轴・加入帮派 : 完成相应目标后可以获得奖励。
任务卷轴・天罡地煞 : 完成相应目标后可以获得奖励。
任务卷轴・答题 : 完成相应目标后可以获得奖励。
任务卷轴・日常任务 : 完成相应目标后可以获得奖励。
任务卷轴・守护神 : 完成相应目标后可以获得奖励。
任务卷轴・帮派任务 : 完成相应目标后可以获得奖励。
任务卷轴・除暴任务 : 完成相应目标后可以获得奖励。
任务卷轴・降妖任务 : 完成相应目标后可以获得奖励。
任务卷轴・副本任务 : 完成相应目标后可以获得奖励。
任务卷轴・天降大任 : 完成相应目标后可以获得奖励。
任务卷轴・占星问道 : 完成相应目标后可以获得奖励。
任务卷轴・幸运大使 : 任务卷轴给予的指引任务，完成相应目标后可以获得奖励。
任务卷轴・押镖 : 完成相应目标后可以获得奖励。
任务卷轴・节日奖励 : 任务卷轴给予的指引任务，完成相应目标后可以获得奖励。
任务卷轴・萝卜桃子 : 任务卷轴给予的指引任务，完成相应目标后可以获得奖励。
任务卷轴・试道大会 : 完成相应目标后可以获得奖励。
任务卷轴・门派比武 : 完成相应目标后可以获得奖励。
任务卷轴・领双 : 完成相应目标后可以获得奖励。
任务卷轴・妖魔道 : 完成相应目标后可以获得奖励。
任务卷轴・仙魔录 : 完成相应目标后可以获得奖励。
任务卷轴・宠物强化 : 完成相应目标后可以获得奖励。
筹备晚宴  : 国庆佳节，举国欢腾，大家齐聚一堂共享美味佳肴，我们快为这即将到来的盛大晚宴出把力吧。
功勋加速 : 你领取了功勋加速任务，可以在国庆相关活动中以#R10#n倍的速度获得功勋值。
为国建功 : 国庆期间参与各种活动均可获得#R功勋#n，#R功勋#n可以在#R2010年10月8日零点#n前用来在#P国庆大使|天墉城（285，186）#P处兑换各种丰厚的奖励。
保卫中州 : 千里之堤，溃于蚁穴，只有清除了那些到处破坏中州基石的鼠辈，我们的家园才能安稳。
勤学苦练 : 转眼间，你已经30级了，现在可以了解更深一层的知识了，在了解了加点与未来的职业发展方向的知识后，你需要勤学苦练才能有所突破。#r【此任务在玩家等级超过60级后自动消失】

携宠除魔 : 在你达到40级之后，你可以了解宠物技能的知识，让爱宠学会天书技能，以便更好的行走于江湖。
学艺有成 : 在你达到70级之后，你已经学艺有成了！穿上证明自己实力的套装，向修真问道之路勇敢的前行吧！
师门学艺 : 你加入了门派，努力为师门做事吧，没事要多请教师门童子学习更多的知识。
初入江湖 : 除了每日师门任务以外，适当入世修行可以更快提高自己的能力。通过收集各种晶石，可以将自己的武器装备提高一个档次。
学习地图精灵 : 学习如何使用地图和NPC精灵。
深山修行 : 在你达到60级之后，你可以了解宠物武学的相关知识、宠物武学的提高有助于宠物提升抗障碍的能力；你还可以与各门派神仙进行切磋、快速获得升级经验。
初来乍到 : 你来到揽仙镇，在了解自己的身世后，学习了一些基本知识，从而走上了修行之路。
领取武器 : 前往#P张老板#P处领取一把武器。
领取装备 : 前往#P卜老板#P处领取一套装备。
仗剑江湖 : 在你达到50级之后，你可以了解道行和障碍技能的相关知识，以便更好的行走于江湖。
鱼饵 : 你吃下了飞毛腿宝宝制作的鱼饵，感觉自己变成了一个鱼饵！
炼丹系统指引 : 本任务指引您如何使用炼丹炉炼丹。
天降大任指引:    本任务指引您了解天降大任任务的相关知识。
日常任务指引:    本任务指引您了解日常任务的相关知识。
八阵图系统指引:    本任务指引您了解八阵图系统的相关知识。
修行任务指引:    本任务指引您了解修行任务的相关知识。
十绝阵系统指引:    本任务指引您了解十绝阵系统的相关知识。
门派试炼任务指引:    本任务指引您如何进行门派试炼。
师门任务任务指引:    本任务指引您如何领取师门任务。
除暴任务指引:    本任务指引您如何领取除暴任务。
降妖任务指引:    本任务指引您如何领取降妖任务。
伏魔任务指引:    本任务指引您如何领取伏魔任务。
仙界通缉任务指引:    本任务指引您如何领取仙界通缉任务。
五人副本系统任务指引:    本任务指引您了解五人副本任务。
师门守卫任务指引:    本任务指引您如何参加师门守卫活动。
真假幻妖活动指引:    本任务指引您如何进行真假幻妖活动。
萝卜桃子大收集活动任务指引:    本任务指引您如何进行萝卜桃子大收集活动。
虎狼争霸活动任务指引:    本任务指引您如何进行虎狼争霸活动。
押镖活动指引:    本任务指引您如何进行押镖活动。
日常领取活动任务指引:    本任务指引您如何进行日常领取活动。
捉迷藏活动指引:    本任务指引您如何进行捉迷藏活动。
出师任务指引:    你想了解如何出师吗？本任务指引你如何进行出师。
同甘共苦任务指引:    前往#P大胡子#P处可以领取同甘共苦任务，本任务指引您如何领取该任务。
装备改造系统指引:    本任务指引您如何进行装备的改造。
装备合成系统指引:    本任务指引您如何进行装备的合成。
装备拆分系统指引:    本任务指引您如何进行装备拆分的操作。
装备重组系统指引:    本任务指引您如何进行装备重组的操作。
超黑三合一系统指引:    本任务指引您如何进行超级黑水晶三合一的操作。
粉装备炼化系统指引:    本任务指引您如何进行粉装备炼化的操作。
装备品质转换系统指引:    本任务指引您如何进行装备品质转换的操作。
套装炼化系统指引:    本任务指引您如何进行套装炼化的操作。
装备强化系统指引:    本任务指引您如何进行装备强化的操作。
装备属性限制转换系统指引:    本任务指引您如何进行装备属性限制转换的操作。
装备封印系统指引:    本任务指引您如何进行装备封印的操作。
饰物合成系统指引:    本任务指引您如何进行饰物的制作和合成。
法宝系统指引:    本任务指引您如何获得法宝和如何使用法宝。
装备进化系统指引:    本任务指引您如何进行装备的进化。
帮战系统指引:    你想参加令人紧张而又有趣的帮战吗？赶快前往#P帮派使者#P处了解帮战系统，本任务指引您如何参加帮战。
功德兑换系统指引:    前往#P帮派使者#P处了解功德兑换系统，本任务指引您了解功德兑换系统。
帮派触发BOSS任务指引:    前往#P帮派使者#P处领取帮派触发BOSS任务，本任务指引你如何进行该任务。
帮贡兑换物品任务指引:    前往#P帮派使者#P处了解如何使用帮贡兑换物品，本任务指引你如何进行该操作。
帮派研发技能任务指引:    你想了解如何研发帮派技能吗？本任务指引你如何进行帮派技能研发。
帮派任务指引:    前往#P帮派使者#P处了解帮派任务，本任务指引您如何领帮派任务。
帮派俸禄任务指引:    本任务指引您了解如何领帮派俸禄的相关知识。
宠物进化系统指引:    本任务指引您如何进行宠物的进化。
骑宠融合系统指引:    本任务指引您如何进行骑宠融合的相关操作。
宠物点化系统指引:    本任务指引您如何进行宠物的点化。
宠物强化系统指引:    本任务指引您如何进行宠物的强化。
炼妖系统指引:    本任务指引您如何给宠物打入炼妖石以增强其能力。
宠物天书系统指引:    本任务指引您如何给宠物学习天书技能以增强其能力。
坐骑系统任务指引:    本任务指引您了解如何获得一只精怪并将它转化成坐骑的相关知识。
宠物飞升指引:    本任务指引您如何飞升宠物。
师徒系统任务指引:    前往#P辛仁皑#P处了解师徒关系系统，本任务指引您如何拜师和收取徒弟。
结拜系统指引:    你想了解如何结拜吗？本任务指引你如何进行结拜。
结婚系统任务指引:    前往#P红娘#P处可以领取结婚任务，本任务指引您如何与其他异性玩家结婚。
跨服联赛指引:    本任务指引您如何参与跨服联赛。
试道大会任务指引:    本任务指引您如何参加试道大会。
门派比武大会任务指引:    本任务指引您如何参加门派比武大会。
证道殿任务指引:    本任务指引您如何进入证道殿进行挑战。
英雄会任务指引:    本任务指引您如何参加英雄会。
擂台比武任务指引:    本任务指引您如何参加擂台比武。
强制PK任务指引:    本任务指引您如何进行强制PK。
掌门系统任务指引:    本任务指引您如何去挑战掌门。
钱庄系统任务指引:    本任务指引您了解钱庄系统。
摆摊系统任务指引:    本任务指引您了解摆摊系统。
商会系统任务指引:    本任务指引您了解商会系统。
拍卖系统任务指引:    本任务指引您了解拍卖系统。
点卡寄售系统任务指引:    本任务指引您如何了解点卡寄售系统。
元宝交易系统任务指引:    本任务指引您了解元宝交易系统。
技能精研系统指引:    本任务指引您如何进行技能精研。
占卜系统指引:    本任务指引您如何进行占卜。
加锁系统指引:    本任务指引您如何进行加锁的相关操作。
认主系统指引:    本任务指引您如何进行认主的相关操作。
绑定系统指引:    本任务指引您如何进行绑定的相关操作。
BOSS系统任务指引:    本任务指引您如何体验BOSS系统。
悬赏BOSS任务指引:    本任务指引您了解悬赏BOSS任务。
天罡星系统任务指引:    本任务指引您了解天罡星系统。
上古妖王任务指引:    本任务指引您了解上古妖王任务。
海盗入侵任务指引:    本任务指引您了解海盗入侵任务。
寻宝系统任务指引:    本任务指引您如何获取寻宝任务。
南荒巫术系统任务指引:    本任务指引您如何领取南荒巫术任务。
收集材料任务指引:    20至80级玩家每日前往#P念心道人#P处帮助其收集材料，可以获得奖励，本任务指引您如何领取收集材料任务。
答题系统任务指引:    本任务指引您了解答题系统。
工资系统任务指引:    本任务指引您了解工资系统。
福利彩票系统任务指引:    本任务指引您了解福利彩票系统。
天降福星系统任务指引:    本任务指引您了解天降福星系统。
神仙下凡任务指引:    本任务指引您了解神仙下凡系统。
游戏币兑换系统任务指引:    本任务指引您了解游戏币兑换系统。
五行竞猜系统任务指引:    本任务指引您了解五行竞猜系统。
守护系统任务指引:    本任务指引您了解守护系统。
阵法系统指引:    本任务指引您了解阵法系统。

问道秀系统任务指引 : 本任务指引您如何使用问道秀系统。
帮派名人堂任务指引 : 本任务指引您如何进入帮派名人堂进行挑战。
帮派守卫战之强盗来袭任务指引 : 本任务指引您如何参加帮派守卫战――强盗来袭。
帮派守卫战之旱魃入侵任务指引 : 本任务指引您如何参加帮派守卫战――旱魃入侵。
帮派圈圈乐任务指引 : 本任务指引您如何参加帮派圈圈乐活动。
捣乱的后果 : 到#P秋水仙子|天墉城(285，186)#P处捣乱，结果被处罚了，变成了这副模样。
归还礼物 : 打开礼品，你依稀辨识出这是一份送给师尊们的礼物，但是礼包已经破败不堪了。
金秋感恩 : 金秋时节，普天之下均欢庆丰收，中州也不例外，大家快去找#P秋水仙子|天墉城(285,186)#P了解如何庆祝吧。
每日感恩 : 感谢伙伴们的陪伴，在这感恩的时刻，给你5个不同门派的在线好友带去感恩节的祝福。
圣诞的劳碌 : 圣诞节就要到了，而我们#P可怜的小鹿|揽仙镇(307,41) #P把圣诞礼物给弄丢了，大家快去帮帮它吧。

探寻圣诞 : 宁静的揽仙镇处突然来了一只神情狼狈的金色小鹿，好像出了点事情，道友何不前去看看？
强盗的宝藏 : 你无意中获得了一张强盗留下的藏宝图，真是激动啊，不知道会挖到些什么东西。
雪人与驯鹿 : 圣诞佳节，调皮的雪人和捣乱的驯鹿在#Z官道南#Z打雪仗，我们也去玩玩吧。
摘星夺魁 : 元旦佳节，九天之上的星官们也都下界来游玩，顺便指点尘世子民修行，大家快去找星官们切磋以提升自己的修为吧。切磋成功可以获得#R仙魂露#n，带到天墉城#R生肖使者#n处，让她帮你做成一个精美的#R元蛋#n，元蛋使用后可以获得丰厚的奖励哦！
乾坤锁订单 : 您订购的乾坤锁因#R信息有误#n而无法送达，需重新填写订单。
撤销乾坤锁订单 : 您订购的乾坤锁因#R地区过于偏远#n而无法送达，我们将退还您使用的#R乾坤锁#n道具。
节节高升 : 在场内与其他玩家进行比试，考究自己的实力。
新年愿望 : 新年到了，大家有什么愿望可以找#Z天墉城#Z的#P节日大使#P许下新年的愿望。
冰上钓鱼大赛 : 通过右键点击使用包裹栏中的鱼食，可以有一定几率钓到鲜活的大鱼哦。
夺宝之战 : 在藏宝之地帮助你的门派获取夺宝之战的胜利。
雪战冰原 : 用锄头在附近地上采集取雪球，为战斗储备武器。战斗开始后，可用雪球攻击对方。
如何获得娃娃指引 : 本任务指引您了解如何获得娃娃。
娃娃拜师系统指引 : 本任务指引您了解娃娃拜师系统。
如何携带娃娃指引 : 本任务指引您了解如何携带娃娃。
娃娃成长指引 : 本任务指引您了解如何使娃娃成长。
娃娃历险系统指引 : 本任务指引您了解娃娃历险系统。
娃娃切磋系统指引 : 本任务指引您了解娃娃切磋系统。
娃娃比武指引 : 本任务指引您了解如何使娃娃比武。
娃娃参战系统指引 : 本任务指引您了解娃娃参战系统。
娃娃组队指引 : 本任务指引您了解如何使娃娃组队。
每日感恩 : 感谢伙伴们的陪伴，在这感恩的时刻，给你5个不同门派的在线好友带去感恩节的祝福。
冰上钓鱼大赛 : 通过右键点击使用包裹栏中的鱼食，可以有一定几率钓到鲜活的大鱼哦。
辞旧迎新 : 大年三十来啦，我们一起来辞旧迎新过新年吧。
清扫街道 : 新年就要来啦，我们一起来把我们的城镇打扫干净吧。
制作超级大红包 : 春节到了，怎么能少红包呢！你是否也想试试自己做红包呢？
装扮新年 : 马上就是除夕了，我们的天墉城岂能不焕然一新，让我们一起来把它变得漂漂亮亮的吧。
神兽贺新春 : 上古神兽们都到天墉城游玩，大家快去给他们拜年吧。
小年祭灶 : 灶王爷要上天汇报我们一年的功过了，我们快做点糖瓜给他让他回去多说点好话吧。
除夕煮饺子 : 大年三十煮饺子，吃饺子，自己动手，丰衣足食。
佳节煮元宵 : 元宵佳节煮元宵，吃元宵，自己动手，丰衣足食。
铲除妖王 : 妖王乱世，你的能力已经震慑了妖王，赶紧去消灭它吧！
黄金罗盘 : 上古时有大法力者在凡界遗落了众多宝物，宝物灵气冲天时，#R黄金罗盘#n可感应到其所在。
订购乾坤锁 : 您成功订购了光宇华夏密保乾坤锁，我们将尽快将其送达。如您的帐号之前从未绑定乾坤锁，首次绑定可领取丰厚奖励。
小妖猎人 : 你在妖王入侵时铲除小妖表现杰出，你可以去#P仙界神捕#P处领取奖励（每天仅限一次）。
抢彩蛋 : 任务介绍：周年庆，抢彩蛋，得好礼。得到周年庆彩蛋，右键使用可以获得意外惊喜，你使用了一个周年庆彩蛋，接到了一个秘密任务。
幸运大猜奖 : 找出捣乱的宠物。
祝福问道 : 问道五周岁了，祝福问道吧！
探寻生辰秘笈 : 探寻自己的生辰秘笈。
莲灯许愿 : 去找天墉城的#Y五周年庆典大使#n购买莲花姑娘制作的#R莲灯#n，到揽仙镇右键使用放入河中，即可许下你心中暗藏已久的愿望。集齐#R问道周年庆典卷轴#n，就有可能使愿望实现。
七星拱月 : 挑战北斗七星君！
接力卷轴・东海渔村 : 接力卷轴中包括一系列可以完成的任务，每一个完成任务的角色，其名称都会被记录在接力卷轴中。#R提示：经验类卷轴和道行类卷轴每日最多可以分别获得前#n#Y24次#n#R奖励，超出的次数将自动被没收。#n
接力卷轴・揽仙镇 : 接力卷轴中包括一系列可以完成的任务，每一个完成任务的角色，其名称都会被记录在接力卷轴中。#R提示：经验类卷轴和道行类卷轴每日最多可以分别获得前#n#Y24次#n#R奖励，超出的次数将自动被没收。#n
接力卷轴・天墉城 : 接力卷轴中包括一系列可以完成的任务，每一个完成任务的角色，其名称都会被记录在接力卷轴中。#R提示：经验类卷轴和道行类卷轴每日最多可以分别获得前#n#Y24次#n#R奖励，超出的次数将自动被没收。#n
接力卷轴・无名小镇 : 接力卷轴中包括一系列可以完成的任务，每一个完成任务的角色，其名称都会被记录在接力卷轴中。#R提示：经验类卷轴和道行类卷轴每日最多可以分别获得前#n#Y24次#n#R奖励，超出的次数将自动被没收。#n
五行争霸 : 击杀尽量多的霸王剑，为你选择的派系赢得胜利。
挑战龙神 : 赛旱龙舟实际上是一种祈福舞蹈，现在你可以向#R五龙神#n挑战，为家人祈福，挑战时可用粽子祭祀#R五龙神#n以降低挑战难度，或者使用#Y雄黄酒（老酒）#n来获得更高奖励。
感谢父亲 : 父爱与母爱一样都是伟大的爱，趁着父亲节这个机会，跟父亲说几句话吧。
父爱如山礼盒 : 父爱深沉似海，恩重如山，父亲节来临之际，做个礼盒表示一下吧！材料在各个普通练功区、降妖、伏魔、仙界通缉、修行、十绝阵系统中均有掉落。
父亲节任务 : 我们的老熟人黄仨儿，从小由揽仙镇的村民带大，关于父亲的记忆已经模糊，协助黄仨儿寻找自己的父亲，可获得大数量数值奖励，还有机会获得各种商城道具哦。
挖瓶子 : 自上古以来，漂流瓶便是人们穿越广阔大海进行交流的一种有趣而又传奇的方式，丢进大海的漂流瓶充满着无限未知的神秘气息，而又被意外挖起的瓶子更是一种上天赐予的幸运啊，快快行动吧！
丢瓶子 : 自上古以来，漂流瓶便是人们穿越广阔大海进行交流的一种有趣而又传奇的方式，丢进大海的漂流瓶充满着无限未知的神秘气息，快来试试吧！
玄冥洞窟 : 神秘的玄冥洞窟其实是传说中的藏宝之地，赶紧去寻找吧！也许会有意想不到的惊喜哟！（#R若离开洞窟，无法再次进入洞窟，且捡到的玉石与卡片都将消失。#n）
地府・超度亡魂 : 地府中流浪着许多混混僵僵的亡魂，带他们去六道轮回投胎，即可获得无上功德。
神秘乾坤图 : 相传圣境中藏有至宝乾坤图，乾坤图将给善良的人们带来好运。
亲子任务 : #R乐豆豆#n每天都会开办亲子活动，带着孩子参加不光有利于孩子们的成长，还对父母的修行有所帮助！
地府・炼化鬼灵珠 : 收集#R恶鬼#n身上的鬼气，然后找#P白无常#P帮忙炼化为#R鬼灵珠#n。
地府・挖掘鬼物 : 魂为天气，魄为地气；若人死，则魂升天、魄归地，鬼物乃魄之所依。
竞技试炼 : 接受各式竞技之试炼，以备他日之用。
挑战六道 : 超出六道、不堕轮回，方为大道。
鬼宠任务 : 经过#Y黑无常#n的加持，你已经可以暂时性地忽视鬼域四魔灵的封印力量了，现在可以去挑战鬼域四魔灵了。
地煞星系统任务指引 : 本任务指引您了解地煞星系统。
蛋糕送祝福 : 把多闻道人送你的生日蛋糕与好友一起分享，就可以换取更多惊喜哦！#R任务仅限生日当天有效#n。
创帮庆典 : 创帮庆典是本帮一年一度的大事，在创帮庆典中你可以积累活跃度，然后使用活跃度向其他的帮派NPC兑换想要的奖励#R（只有在庆典当天可以兑换）#n。
建设纪念塔 : 为了在创帮庆典中建造一座纪念塔来纪念帮派事迹，所有帮派成员都该动员起来为建设纪念塔而努力。
创帮庆典特殊奖励 : 你们的帮派在创帮庆典中气氛活跃，每个人都获得了一定次数帮派任务特殊奖励的资格。该资格在创帮庆典之后的一个月内有效，超过时间或任务次数使用完毕后失效。每日先消耗帮派任务次数再消耗额外奖励次数，10次帮派任务可替换为1次帮派日常挑战。
鸿运当头 : 使用鸿运签换取道具。
问道选秀 : 问道选秀活动期间，你可以在#P问道选秀大使处#P给喜爱的选手投票。
地府・功德榜 : 善者累千世之功德，终成善果，以此纳入功德榜，入功德榜者将得#Y地藏王#n护佑，将有几率躲避地府怪物临死反扑。
地府指引 : 千年动荡，地府现世。妖魔横行，鬼王猖獗。功德护佑，光明加持。四方魔灵，共护冥址。
封印之法 : 地府通道现世，恶鬼逃窜，危害人间，请向四方守护神（#P青龙#P、#P白虎#P、#P朱雀#P、#P玄武#P）请教对付恶鬼的#R封印之法#n。
慧眼识鬼 : 地府中逃窜出的#Y恶鬼#n埋伏在#Z天墉城#Z中，准备等天黑之后发动攻击。玩家可在#P阎罗王#P处领取#Y阴阳罗盘#n以探寻恶鬼的藏身之所。
重归平静 : 虽然天墉城的修真者挡住了一波又一波恶鬼的攻击，只要地府通道仍然开启着，天墉城的威胁就未能消除。前往地府，与#Y地狱四魔灵#n商讨解决的办法。
学习腾云驾雾 : 修道之人，当翱翔九天、不羁万物，今既有机缘，不可不争。
签解姻缘 : 自古好姻缘都是通过层层考验争取来的。修道之人，其姻缘考验自然更严格些。
姻缘一线牵 : 一年一度的七夕节又来到了，在这七天里，如果你每天都到#P七夕节活动大使|天墉城(212,188)#P处帮些小忙，也许会有意外的惊喜哦！
遥寄心意 : 揽仙镇上的#Y牛郎#n一直对#Y织女#n有意，但无奈为人憨厚，不善言辞，不知如何开口。
捍卫姻缘 : #Y牛郎#n、#Y织女#n终于在一起生活了。男耕女织，羡煞旁人。那#Y织女#n原是天上仙女，天庭发现此事，派天兵要把她抓回去。
男耕女织 : #Y牛郎#n、#Y织女#n经过几天的抵抗最后还是被分开了，只能在每年的七夕节那天相会。他们能否天天在一起，过上男耕女织的幸福生活呢？
获得娃娃 : 单身的人想要成为父母，需要先得到#Y乐善施#n的证明，否则#Y送子娘娘#n是不会放心把娃娃交给你的。
娃娃指引・装备合成 : 用#Y送子娘娘#n给的材料，到#P慧慧儿#P处给娃娃做一件衣服，可以提高娃娃在战斗中的能力。
娃娃指引・亲子活动 : 带上你的娃娃去找#Z揽仙镇#Z的#P乐豆豆#P玩吧，那里小孩可多了呢，小孩子们最喜欢找她玩了，还能够获得丰厚的奖励哦！
【国庆】筹备晚宴 : 国庆佳节，举国欢腾，大家齐聚一堂共享美味佳肴，我们快为这即将到来的盛大晚宴出把力吧。
【国庆】功勋加速 : 你领取了功勋加速任务，可以在国庆相关活动中以#R10#n倍的速度获得功勋值。
【国庆】为国建功 : 国庆期间参与各种活动均可获得#R功勋#n，#R功勋#n可以在#R2010年10月8日零点#n前用来在#P国庆大使|天墉城（240，187）#P处兑换各种丰厚的奖励。
【国庆】保卫中州 : 千里之堤，溃于蚁穴，只有清除了那些到处破坏中州基石的鼠辈，我们的家园才能安稳。
【教师节】师门叛逆 : 尊师重教是中国的优良传统，早在公元前11世纪的西周时期，就提出“弟子事师，敬同于父”，教师被中国人誉为人类灵魂的工程师。
【教师节】桃李天下 : 尊师重教是中国的优良传统，早在公元前11世纪的西周时期，就提出“弟子事师，敬同于父”，教师被中国人誉为人类灵魂的工程师。
【教师节活动】 : 尊师重教是中国的优良传统，早在公元前11世纪的西周时期，就提出“弟子事师，敬同于父”，教师被中国人誉为人类灵魂的工程师。
双倍奖励时间（娃娃） : 在娃娃双倍奖励时间，娃娃获得训练进度为平时的两倍。
【娃娃指引・装备合成】 : 用#Y送子娘娘#n给的材料，到#P慧慧儿#P处给娃娃做一件衣服，可以提高娃娃在战斗中的能力。
【娃娃指引・领取双倍】 : 带上你的娃娃去找#Z天墉城#Z的#P乐豆豆#P领取娃娃双倍修炼时间，战斗时携带娃娃并勾选“训练”可以获得双倍经验，这样娃娃成长起来会更快哦！
捕捉精怪 : 通过#Y玉真子#n处打听精怪出没的地点，根据提示地点，与精怪战斗，胜利之后可以获得精怪。
【活动】榜上有名 : 正所谓天外有天，人外有人，中洲大陆高手如云。活动期间有实力上排行榜的，就有机会获得神兽大奖。
七星阵 : 古往今来，多少人想破解七星剑阵，却无一人成功，今日机缘巧合，也许就有机会破解这千古之谜了。
日领取活动 : 每天可向天墉城的#P问道活动大使#P领取修炼时间，修身悟道，提高修行进度。普通任务每天可领取2小时，天罡任务和挑战任务只能领取1小时修炼时间。
角色公示期 : 角色可以通过奇宝斋进行寄售，在寄售之前，角色需要经过公示期，公示期期间，角色将接受其它玩家的监督，如果角色被其它玩家举报，将影响角色的成功寄售。
娃娃冒险任务 : 每个人童年都有去冒险的经历，但是现在有些小朋友却找不到愿意和他们一起去探险的人。和你的朋友一起带着你们的娃娃，去陪这些小朋友展开大探险吧。
【光棍节】我的生活 : 快乐单身和幸福情侣，哪个才是我们正确的选择？带上你的决定，前往#P快乐单身#P和#P幸福情侣#P投票，赢取#R双倍大奖#n吧。
【光棍节】捣乱小妖 : 快乐单身和幸福情侣，哪个才是我们正确的选择？在我们思考这个人生哲理的时候，居然有一群小妖前来捣乱！赶快消灭这些让人讨厌的家伙吧。
【亲子活动】娃娃冒险 : 每个人童年都有去冒险的经历，但是现在有些小朋友却找不到愿意和他们一起去探险的人。和你的朋友一起带着你们的娃娃，去陪这些小朋友展开大探险吧。
【万圣】变身糖果 : 万圣节的精神就是各种变身，各种捣乱。
【亲子】拯救小熊 : 憨厚可爱的玩具小熊娃娃，被黑熊怪夺走了。挑战黑熊怪，寻回玩具娃娃，陪它玩耍吧。
【感恩节活动】 : 一年一度的感恩节来临了，在这个特殊的日子里，让我们静下心来，想一想那些曾经帮助过我们的人和我们需要感谢的人。
【感恩节活动】幸存的火鸡 : 每年感恩节都有无数的火鸡被送进了烤炉，今年也不例外。现在我这里有1只火鸡逃过了被送进火炉的命运，如果天意如此的话，还是将他放回深山好了。但是我知道#Z桃柳林#Z、#Z轩辕庙#Z、#Z风月谷#Z的怪物都在打这只火鸡的主意，你能去击败这些怪物并将这只幸存的火鸡安全的护送回深山么？
武状元争夺赛 : 武道者，以武止伐，平息干戈，习武者，应以为国为民为己任，故在此设立武状元争夺赛，以求天下贤士！
【万圣节】化妆舞会 : 万圣节前夜，让我们来一起狂欢吧！
千变万化 : 任务介绍：古老相传，怪物魂魄被凝结后，化身其中便可得到其道修精华。
问卷调研 : 任务介绍：你可以在#Z天墉城#Z的#P问卷调查专员#P处参加问卷调查，完成后将得到声望荣誉奖励。
地劫任务 : 任务介绍：飞升之路曲折坎坷，唯有通过十重劫难之人才能最终得道飞升。
八阵图 : 任务介绍：八卦之象演出八阵图，现由#P青龙#P、#P白虎#P、#P朱雀#P、#P玄武#P四圣兽守护。如能在八阵图中修炼，必可事半功倍。
【圣诞】圣诞狂欢 : 叮叮当，叮叮当，铃儿响叮当……圣诞的钟声已经响起，大家一起快来狂欢吧！
太虚圣境 : 太虚圣境中之中有一批精于锻炼法宝的神将，若有幸遇之，可向其寻求修法炼宝之妙法！
【元旦】百花仙子 : 新的一年来临了，百花仙子们纷纷下凡#Y风月谷#n欢度新年的到来。谁能抓住这个机会获得百花仙子的青睐，得到百花仙子的芳心呢？心动不如行动，赶快行动起来吧！
二十八星宿挑战 : 相传二十八星宿身为天庭的护卫神，一直以来尽忠职守，各个也是身手不凡，堪称高手中的高手。
帮派日常挑战 : 帮派组织的日常活动，各帮派成员应积极为帮派建设出力！
【寒假】步步高升 : 大鱼吃小鱼、小鱼吃虾米，弱肉强食是亘古不变的生存法则。#R黄沙镇#n内条件恶劣，适者生存。
开启元神出战 : 在#Z地府#Z找到沉睡千年的#P望乡石#P，在那里开启元神出战，到时需要将参战装备开启#R附魂转化率#n，该属性能嵌入元神体内，激发元神的战斗力，每件装备上最高属性值可达20%。
天人合一 : 完成天人合一系统，是飞升后需要完成的任务之一，可以将元神合入自身体内，道行累加到真身身上，从而提高自身能力。战斗中真身被障碍，元神依然会出窍，完成该任务可根据真身能力提高元神攻击#R（注：该任务完成时，元神若有穿装备将被回收）#n。
【元宵节】元宵大仙 : 汉明帝为了弘扬佛法，下令正月十五夜在宫中和寺院“燃灯表佛”，因此正月十五夜燃灯的习俗随着佛教文化影响的扩大及道教文化的加入逐渐在中国扩展开来。
【元宵节】闹元宵 : 汉明帝为了弘扬佛法，下令正月十五夜在宫中和寺院“燃灯表佛”，因此正月十五夜燃灯的习俗随着佛教文化影响的扩大及道教文化的加入逐渐在中国扩展开来。
【寒假】走亲访友 : 假期即将结束，趁着这个机会去拜访一下亲戚朋友吧。
【寒假】日记本 : 妖怪们趁乱抢走了天墉城小朋友的日记本，现在妖怪四散在#R天墉城#n。请道友前去挑战他们，夺回日记本！
【指引】新法宝系统 : 法宝是附带法力的宝贝，是道家拥有的强大法器。
【春节活动】 : 2012年1月21日至2012年1月29日，#P活动大使#P诚邀各路道友齐聚#R《问道》#n，参与春节活动，赢取#R变异兽#n大奖。
【春节活动】百花齐放 : 又是一年新春到，欢欢喜喜真热闹！为了迎接新春，百花仙子们也下到凡间，各位道友赶紧前往#R天墉城#n#P活动大使#P处领取任务，参与#R百花齐放#n任务吧！
【春节活动】众仙报喜 : 又是一年新春到，欢欢喜喜真热闹！神仙们也耐不住寂寞，纷纷下凡报喜了！
再续问道缘 : 欢迎您来到问道，我们为您准备了两份惊喜！
相约问道 : 再续问道缘活动，让你们相约问道！赶紧去找回你们的昔日伙伴吧！
【春节活动】辞旧迎新 : 又是一年新春到，欢欢喜喜真热闹！十二生肖们也开始轮岗换班了，#P活动大使#P正缺人手，帮他前往#R无名码头#n迎接#P壬辰龙|无名小镇(19,151)#P上任呢！
跨服试道 : 跨服试道大会为大家提供切磋试道的平台，优胜者将可以获得“天下道尊”的称号。
大兴土木 : 任务介绍：修补被怪物破坏的天墉城守护图腾、守护石像。
急速追捕 : 任务介绍：急速追捕是个一追到底的杀怪活动，追捕的速度要够快，获得的奖励才够丰厚。
免费洗点 : 你现在拥有一次免费洗点的机会，如果你对已经分配的属性点感到不满意，那么洗点后这些属性点将全部可以重新分配。#R注意：#n你必须在#R45～50#n级之间使用此洗点机会，到#R51#n级时，此任务将自动取消。
安全设置指引 : 了解游戏的安全保护措施，以便更好地保护自己的帐号安全。
道具挖掘 : 天墉城的无极散人会帮助你挖掘一些道具的隐藏价值，快去找他吧！
狂欢月师徒送大礼 : 2009年12月07日至2009年12月13日期间，在游戏中带徒弟升级超过50级，可以得到由系统送出的额外奖励。徒弟等级越高，师父获得的大礼将越丰厚。\r#R（请于2009年12月27日之前领取）#n
老君查岗 : 任务介绍：老君查岗时你居然不在，老君很生气，后果很严重！
老君惩罚 : 任务介绍：老君发现你投机取巧，不务正业，老君很生气，后果很严重！
升级送道具 : 在活动期间，升到相应的级别后，可以到#Y南极仙翁#n处领取相应的升级奖励。
领取资助 : 任务介绍：#Z揽仙镇#Z的#P乐善施#P向来喜欢助人为乐，常常捐助些钱财给新手玩家。
【中秋】中秋聚月 : 在中秋聚月活动期间提交#R精致中秋月饼#n就能抽取丰厚的奖励。
召唤精怪 : 任务介绍：通过#Y玉真子#n可以召唤特殊的宠物――精怪，这些宠物驯化后可以用来骑乘。
护送朱雀 : 水魔大军侵扰中洲大陆，朱雀子孙前来相助，现今朱雀一族子孙还比较虚弱，需要有人护送。（本任务离队或转移队长时会消失）
火炬传递 : 任务介绍：通过交易给好友的方式，进行揽仙镇火炬大使发放的火炬活动。
虚灵幻境 : 任务介绍：在虚灵幻境中与怪物战斗后可以获得经验或道行奖励。
捉迷藏 : 任务介绍：调皮的十二生肖宠来#Z揽仙镇#Z、#Z东海渔村#Z与大家玩捉迷藏游戏啦！找齐它们，可以去#P生肖使者#P那里兑换奖励。
圣诞宝藏 : 寻找圣诞老人在世界各地埋下的圣诞宝藏。
圣诞许愿 : 许下一个心愿，种下一棵希望。
地劫任务游戏指引 : 任务提示：按照问道小子的指引完成任务，可以更好的熟悉游戏并得到奖励。#R(该任务若在元/血婴升至85级时仍未完成，则任务自动消失)#n
组建团队 : 任务描述：在24小时内组建好团队，然后找赤灵尊神开启副本，进入副本修炼。团队人数少于10人时不可开启副本。副本在24小时内不开启将消失。
烈火涧 : 任务介绍：传说烈火涧内封印着许多上古凶兽，数千年后封印出现了异常，玩家前往调查，并修补好封印。
镇邪冢 : 任务介绍：被黄帝轩辕氏封印在镇邪冢内的邪神蚩尤意欲重现人间兴风作浪，众玩家齐心协力，最终将蚩尤重新封印，免去了一场浩劫。
黑风洞 : 传说黑风洞中出现一头千年狼妖-妖狼王，聚集了无数妖魔鬼怪，意欲兴风作浪。玩家历经艰难险阻，将妖狼王消灭。
出现叛徒 : 任务介绍：僵尸军团中出现叛徒，出卖了自己的同伙。（本任务离队或转移队长时会消失）
逃兵任务 : 任务介绍：追杀僵尸大军中的逃兵（本任务离队或转移队长时会消失）
祭拜祖先 : 又是一年一度的春节，缅怀先祖、祭奠先烈是春节必做的事情！\n（该任务每天只可以完成10次。）
庆典筹备 : 中洲大陆欢庆三周年庆典，但庆典物资仍显紧缺，需要尽快追回流落各地的庆典物资。
消灭恶徒 : 任务介绍：中洲大陆欢庆三周年庆典，不料有恶徒企图破坏、趁火打劫。为了确保庆典的顺利举行，需要消灭恶徒。
天劫任务 : 任务介绍：飞升之路曲折坎坷，唯有通过十重劫难之人才能最终得道飞升。
仙界大叛乱活动 : 仙界大叛乱活动特殊任务。帮助仙界搜集物资，抵抗叛乱的仙界叛逆。每完成1轮10次任务，可以获得奖励。
再续问道积分大礼 : 你可以使用#R再续问道缘积分#n至#P问道缘大使#P处或者使用#R问道嘉年华积分#n至#P董老头#P处参加抽奖。
乾坤八卦阵功臣 : 搭建帮派乾坤八卦阵阵法，需要各位帮众的鼎力支持！
紫微命格 : 紫微星者乃北极紫微大帝也，执掌天经地纬，以率三界星神和山川诸神，是一切现象的宗王，能呼风唤雨，役使雷电鬼神。
【愚人节大冒险活动】 : 完成【愚人节大冒险活动】任务，你将会获得意想不到的惊喜。你敢冒险吗？
折扣豪华婚礼 : 结过婚或完成提亲任务的玩家在#P月老#P处举办豪华婚礼时，可享受折扣优惠。
【甜蜜情人节】 : 再唱不出那样的歌曲，听到都会红着脸躲避……2月14日的情人节，大家把羞涩转换为尽情欢乐吧。活动#R双人组队#n即可参加，期间#R异性组队#n可获得#R双倍#n魅力值，即可在#P活动大使#P处兑奖，更有机会抽得#Y两天技玉兰#n呢！
【开学庆典】 : 为迎接新学期的到来，#Y五耪婢#n为各位道友举办开学庆典，祝各位在新年中学业有成。
【周年】神兽拜福 : 酒心蛋糕是周年纪念宠最喜爱的食物。使用老酒和周年蛋糕可以在炼丹炉中炼制出酒心蛋糕，提交给活动大使可以获得丰厚的奖励。
【周年】妖族入侵 : 六周年本应是喜庆的日子，但是却遭到大批妖族的入侵，是可忍孰不可忍，大家赶紧去消灭这些妖族吧！
【清明还魂祭祖活动】 : 【清明还魂祭祖活动】已经开启，快去参加吧！
首饰充灵模式 : 补充130级以上首饰灵气，在首饰吸取灵气期间，玩家将暂时不能获得经验。
【劳动大联欢】 : 【劳动大联欢】已经开启，快去参加吧！
【周年】九子贺喜 : 六周年之际，龙之九子前来贺喜，他们在#Z天墉城(257,199)#Z接受大家的挑战，据说挑战成功的人可以获得丰厚的奖励。
【周年】五龙散礼 : #Y周年龙仔#n正在天墉城的某处发放红包呢，大家赶紧去寻找它们吧！丰富好礼等你来拿！
【指引】首饰升级指引 : 东海龙宫，珍奇异宝数不胜数。龙宫龙女更是巧夺天工，能将珍奇异宝精炼飞升，令仙界叹为观止。
名人争霸赛 : 名人争霸赛为全区组符合一定条件的角色参加的活动。
名人争霸赛固定队伍 : 只有相约为固定队后才可以进入争霸赛场进行比赛。
丹术・紫蟾聚灵 : 龙宫龙女所创丹术，相传使用者会引来紫蟾，能使将修道之人的修为转化为灵气的法术。
【周年】仙子赐福 : 在这一年一度的周年庆之际，花仙子们被这喜庆的气氛所感染，纷纷下凡赐福了！
【劳动大联欢】双倍奖励 : 【劳动大联欢】活动期间，每晚#R19：00#n至#R19：30#n阶段中战胜#Y太白金星#n即可获得双倍奖励！
【欢乐儿童节】 : 【欢乐儿童节】已经开启，快去参加吧！
【欢乐儿童节】幸福许愿 : 【欢乐儿童节】已经开启，快去参加吧！
【欢乐儿童节】缤纷糖果 : 【欢乐儿童节】已经开启，快去参加吧！
擂台小霸王  : #R擂台小霸王#n，谁是王中王！#P擂台管理人#P在天墉城广发天下道友擂台赛，来试试身手吧。
果果的试炼  : 当#Y果果#n等级达到80级或109级以后，在#Z揽仙镇#Z的#P神宠#P处完成一系列的试炼后，可以使#Y果果#n能力大大提升，突破80级或109级等级限制。
【新手】初访揽仙镇  : 身为多闻道人的骄傲，你马上就将走上真正的修仙问道之路。#r【此任务在玩家等级超过30级后自动消失】
任务卷轴・商城消费  : 完成相应目标后可以获得奖励。
【新手】除暴安天下 : 除了每日师门任务以外，适当入世修行可以更快提高自己的能力。#r【此任务在玩家等级超过50级后自动消失】
【新手】五行化天地 : 转眼间，你已经30级了，现在可以了解更深一层的知识了，在了解了加点与未来的职业发展方向的知识后，你需要勤学苦练才能有所突破。#r【此任务在玩家等级超过60级后自动消失】
【新手】窥得成仙道 : 在你达到50级之后，你可以了解道行和障碍技能的相关知识，以便更好地行走于江湖。#r【此任务在玩家等级超过80级后自动消失】
帮派日常挑战指引 : 在你加入帮派之后，你就可以在#R帮派总坛#n的#P帮派总管#P处领取帮派日常挑战任务，以便更好地提升自己。
【新手】父子齐上阵 : 提高自己的能力，需要潜心修炼，叫上伙伴带上娃娃一起深山修行。#r【此任务在玩家等级超过90级后自动消失】
【新手】金身略有成 : 在你达到70级之后，你已经学艺略有所成了！穿上证明自己实力的套装，向修真问道之路勇敢的前行吧！#r【此任务在玩家等级超过100级后自动消失】
【新手】结伴闯天涯 : 除了自身修炼外，宠物的修炼也不能落下，结伴而行，事半功倍。#r【此任务在玩家等级超过70级后自动消失】
地府总动员 : #R【周活动】地府总动员#n 活动开启时间为#R15：00#n到#R16：00#n以及#R19：00#n到#R20：00#n，活动期间所有等级达到40级的玩家可以前去找#Z地府#Z的#P阎罗王#P领取活动任务，组队前去消灭#Z黄泉路#Z、#Z奈何桥#Z和#Z地府#Z游荡着各种鬼魂或者去帮助#P饿鬼|黄泉路（22，55）#P和#P酒鬼|奈何桥（61，62）#P 完成他们的愿望！
娃娃日常活动 : 每天可让天墉城的#P乐豆豆#P帮助你的娃娃激发潜能，修身悟道，提高娃娃修行进度。
天罡十绝阵 : 法道无为乃修行之本，历练各种自然道法更能精进你的修为，天罡十绝阵威力非凡，还是小心为妙。
【新手】千里不独行 : 尚未恢复全部功力的你，需要在门派的帮助下，开启全新的修真之旅。#r【此任务在玩家等级超过40级后自动消失】
【端午蜜粽抢不停活动】 : 【端午蜜粽抢不停活动】在活动期间均可参加。#R(每天可获得20场战斗的奖励)#n
增加四倍阵型熟练度时间 : 在任务时间内可增加四倍阵型熟练度的奖励。
任务卷轴・帮派日常挑战 : 完成相应目标后可以获得奖励。
仙人巡游 : 中洲大陆的一些仙人最近闲来无事，携带着大量的财物在#Z天墉城#Z晃悠，据说通过他们考验的玩家可以获得丰厚的奖励。
护宝大战 : 护宝大战分为两个阶段，第一阶段为#R斩妖除魔#n阶段，第二阶段为#R共斩盗圣#n阶段，第一阶段排名靠前的门派在第二阶段的战斗中可以获得更高的奖励。
【指引】学习阵型-万象宇化 : 在PVP、PVE战斗中，大家可以使用阵型系统，该任务将指引你如何使用阵型，以发挥更强的战斗力。
【暑假】中洲暑期见闻 : 为了小宝记录暑期你在中洲的见闻，能让小宝在暑期之后，仍能回忆起在中洲的生活。
【暑假】小宝大胃王 : 暑假天气炎热，听说#Z北海沙滩#Z的#Y虾兵、蟹将#n身上有许多美味解暑的#R沙冰#n，大家快去要些来给小宝解暑吧！
【暑假】小宝游龙宫 : 夏天来了，天气好热啊！快来游泳清凉一下吧！
【暑假】小宝惹人爱 : 夏总兵的侄子#Y夏小宝#n来天墉城做客，好客的天墉城居民们准备了礼物给小宝，大家快帮居民们把礼物集中到#P活动大使#P处，任务完成后可以获得丰厚的奖励哦！
【暑假】小宝遇险记 : 炎炎夏日，暑假到来了，夏总兵的侄子夏小宝来到了天墉城；完成夏小宝委托给活动大使的相关任务，就能获得大奖。
【暑假】小宝育仙树 : 短暂的暑假就要过去了，小宝马上要离开天墉城了，他希望在桃柳林种下一棵仙树，你能帮助他吗？
【暑假】小宝斩妖魔 : 炎炎夏日，暑魔乘机在天下为非作歹，修道之人必将斩杀妖魔。
幸运魔方 : 今天你被小糊涂神幸运地砸到了，在未来的一段日子里，你可能会比较幸运哦。
【足球】2012欧洲杯竞猜 : 2012年欧洲杯足球赛的竞猜活动，烽火绿茵场，鹿死谁手？
孽债血海 : 玩家主动发起PK，且PK成功，则主动发起PK的玩家及队伍成员均会获得PK值，有PK值的玩家在NPC处购买物品时，价格会变高。有PK值的玩家每死亡一次可以减少1点的PK值，还可以去#P无念僧#P处使用好心值和金钱削减身上的PK值。
【暑假】小宝满载归 : 暑假就要结束了，小宝决定把暑假收的礼物都带回家去，但是总兵大人公务繁忙没时间帮助小宝把礼物运送到无名码头，因此号召众道友前往#P活动大使#P处帮忙小宝运送礼物前往#Z无名小镇#Z！
【暑假】小宝护生灵 : 暑假到了，天干物燥，风月谷居然发生了一场大火，小宝已和夏总兵前往救火，赶快去救助风月谷的小动物们吧。
【双节庆】桂香金秋 : 金秋佳节，举国同庆，#P活动大使#P正在收集#R酒香桂花月饼#n，你若提交#R酒香桂花月饼#n给#P活动大使#P便可获得丰厚奖励。
【双节庆】牧野之战 : 纣王无道，起而伐之。武王善伐谋伐交，亦择时而战，彼时牧野，殷商之旅，其会如林。遥想此役，不免心神激荡，若能得逢其时，生之幸也。
【十二生肖挑战】 : 骄傲的十二生肖宠邀请大家前去挑战，只要挑战胜利就可以获得奖励。
【周活动】盛妆舞会 : #R【周活动】盛妆舞会#n活动期间，所有玩家用#R时装#n装扮自己或#R携带任意形象的变身卡#n均可以在天墉城找#P千面怪#P报名参加活动，用#R时装#n装扮的玩家在活动中可获得超值奖励！(活动双倍、三倍、全局双倍均无效)
【周活动】百兽盛宴 : “百兽盛宴”游戏，变身大挑战乐趣多多。在争霸赛场内捕杀其他怪物可以获得积分，完成升级。
【双节庆】举国同庆 : 玉帝之女找到了其如意郎君，正在#R偶数#n线#Z天墉城#Z举办超豪华#Y神兽游行队伍#n巡游呢，大家快来凑热闹吧，希望在欢度国庆之余给你带来一份意外的惊喜！
【双节庆】盛世奇宝 : 盛世奇宝降临，速去接受挑战。
【双节庆】桂仙考验 : 双节庆之际，#Y桂花仙子#n为大家准备了丰厚的礼物，只要通过#Y桂花仙子#n的考验即可获得奖励，大家赶紧去#P活动大使#P处看看吧！
【双节庆】五行之神 : 天有五行，水火金木土，分时化育，以成万物。修行之中，若能参悟五行之力，自能事半功倍。值双节之庆，#Y五行之神#n邀请众道友共参五行之力。若能参悟其中相生相克之理，更能获得额外奖励。
【奥运会】2012奥运会竞猜 : 2012年奥运会竞猜活动，众神之战的延续，胜利将从这里开始。
龙宫献艺 : 东海#Y龙王#n，邀天墉城道友切磋献艺，你能获得#Y龙王#n青睐，获得奖励吗？
仙人指路 : 路漫漫其修远兮，修炼艰辛，到达一定境界便会难于精进。今奉众位仙家之命，特在此恭候，助你一臂之力，早修正果。
仙人指路（队长） : 路漫漫其修远兮，修炼艰辛，到达一定境界便会难于精进。今奉众位仙家之命，特在此恭候，助你一臂之力，早修正果。
高级仙人指路 : 路漫漫其修远兮，修炼艰辛，到达一定境界便会难于精进。今奉众位仙家之命，特在此恭候，助你一臂之力，早修正果。
高级仙人指路（队长） : 路漫漫其修远兮，修炼艰辛，到达一定境界便会难于精进。今奉众位仙家之命，特在此恭候，助你一臂之力，早修正果。
帮派大战 : 帮派与帮派之间的战斗，胜利方可获得丰厚奖励。
老君发怒 : 老君发现你投机取巧，不务正业，很是生气，决定没收游戏中你的部分奖励！你将无法获得经验、潜能、道行、武学、金钱、道具、物品的奖励。
职业分化・木系 : 木系职业分化需要完成的任务，任务完成后可以学习引灵幡。
职业分化・土系 : 土系职业分化任务，完成后可学会引灵幡。
职业分化・水系 : 水系职业分化需要完成的任务，任务完成后可以学习引灵幡。
接力卷轴・云霄宫一 : 接力卷轴中包括一系列可以完成的任务，每一个完成任务的角色，其名称都会被记录在接力卷轴中。#R提示：经验类卷轴和道行类卷轴每日最多可以分别获得前#n#Y24次#n#R奖励，超出的次数将自动被没收。#n
接力卷轴・云霄宫二 : 接力卷轴中包括一系列可以完成的任务，每一个完成任务的角色，其名称都会被记录在接力卷轴中。#R提示：经验类卷轴和道行类卷轴每日最多可以分别获得前#n#Y24次#n#R奖励，超出的次数将自动被没收。#n
职业分化・火系 : 火系职业分化任务，完成可学会引灵幡。
职业分化・金系 : 金系职业分化需要完成的任务，任务完成后可以学习引灵幡。
元神合体 : #R元神合体#n乃修炼之人毕经之路，收复元神后，道友可以获得两套属性使用资格。#R（注：完成该任务后，元婴/血婴将被回收。）#n
居所任务 : 每日可完成一次居所任务，居所的舒适度越高，任务的奖励就越高。
【引灵幡】奇术炼魂 : 完成神算子的交付的任务需求，能提升你的引灵幡技能上限。
【引灵幡】极速追魂 : 通过赠送炼魂丹给神算子，得到更详实的收伏精怪的信息；完成收伏精怪任务，提升你的引灵幡技能上限。
夺宝奇兵 : 近日有云游仙人发现了一处藏宝圣地，听闻中洲大陆众仙家侠士在此藏匿了不少宝贝，道友快邀上同道中人前去寻宝吧！
地藏王传・坠入地狱 : 介绍深受世人敬仰的地藏王菩萨在成为地藏王之前的故事。
地藏王传・寻找目连 : 介绍深受世人敬仰的地藏王菩萨在成为地藏王之前的故事。
地藏王传・龙宫寻道 : 介绍深受世人敬仰的地藏王菩萨在成为地藏王之前的故事。
地藏王传・解救目连 : 介绍深受世人敬仰的地藏王菩萨在成为地藏王之前的故事。
地藏王传・游魂委托 : 介绍深受世人敬仰的地藏王菩萨在成为地藏王之前的故事。#R（当等级达到116级后可进行）#n
地藏王传・超度亡灵 : 介绍深受世人敬仰的地藏王菩萨在成为地藏王之前的故事。
地藏王传・脱离之法 : 介绍深受世人敬仰的地藏王菩萨在成为地藏王之前的故事。
地藏王传・脱离鬼道 : 介绍深受世人敬仰的地藏王菩萨在成为地藏王之前的故事。
地藏王传・转世回生 : 介绍深受世人敬仰的地藏王菩萨在成为地藏王之前的故事。
地藏王传・入地狱道 : 介绍深受世人敬仰的地藏王菩萨在成为地藏王之前的故事。
【感恩节】焰火晚会 : 焰火晚会正在#Z风月谷#Z火热进行中，快去一同庆祝感恩节吧！
【感恩节】焰火多倍奖励 : 在多倍时间里参与【感恩节】焰火晚会，燃放烟花爆竹参与焰火庆祝可以获得多倍奖励。
【光棍节】激情挑战 : 激情令牌降临，速去接受挑战。
【光棍节】激情欢乐 : 活动期间每天#R7：00-23：59#n的每个整点，会在#Z天墉城#Z刷出许多#R激情欢乐圈#n。该圈持续5分钟，玩家踩的数量越多，获得的奖励越高，大家快来疯狂踩吧！
【重阳节】重阳敬老 : 重阳节，农历九月初九，“九九”谐音是“久久”，有长久之意，所以常在此节期间推行敬老活动。
师门任务  : 接受门派师尊交办的一些事情，完成后会获得嘉奖。（位列仙班玩家每日可多接受10次任务，并奖励金钱。）
【周活动】门派历练 : 五大门派师尊云游天下，途径天墉城，一时兴起，派遣门下弟子在天墉城接受天下仁人志士的挑战。
飞仙渡邪 : 欲成大道，当先渡邪以成其身。
南天门试炼 : 道友已过数重天劫，道行颇深。然筋骨内气依旧是凡仙之质，150级之后完成南天门试炼即可提升筋骨内气。#R（未完成此任务将无法接取天劫第五劫任务）#n
寻仙任务（队长） : 前往蓬莱仙岛寻访八仙，与之切磋仙法以助修行。
寻仙任务 : 前往蓬莱仙岛寻访八仙，与之切磋仙法以助修行。
【指引】居所系统 : 指引玩家体验居所的任务。
宠物羽化修炼 : 宠物羽化修炼任重道远，道友一定要有毅力啊！
宠物羽化飞仙 : 完成宠物羽化飞仙任务后，宠物可开启羽化进阶，待进阶完成后宠物能力可得到大幅度的提升。如有幸获得灵兽精魄，还可改变宠物的形象和类型，即普通宠物可变换为变异、变异可变换为神兽、神兽可变换为元灵。
天牢处罚 : 在你离开天牢后#R7天（168小时）#n的在线时间内，从系统中获得的金钱全部转化为代金券。
天罡寻仙任务 : 前往蓬莱仙岛寻访八仙，与之切磋仙法以助修行，天罡寻仙任务威力非凡，还是小心为妙。
天罡寻仙任务（队长） : 前往蓬莱仙岛寻访八仙，与之切磋仙法以助修行，天罡寻仙任务威力非凡，还是小心为妙。
【迎新年】压岁红包 : 新年到了，压岁红包自然是少不了的，热情的天墉城居民们为大家准备了红包，快去找他们领取压岁红包吧！
【寒假】挽救茅山教 : 茅山教掌教#Y诸葛糊涂#n因醉心炼丹引发的一场浩劫，你敢挺身而出为挽救茅山教出一份力吗？
【寒假】营救教众 : 茅山教掌教#Y诸葛糊涂#n因醉心炼丹引发的一场浩劫，你敢挺身而出为挽救茅山教出一份力吗？
【寒假】刺杀妖魔 : 茅山教受妖魔重创，形势日趋严重。为保全茅山教，诸葛糊涂与众教徒商议，挑选仁人志士前往魔王洞窟，刺杀小妖头目。
【寒假】构筑防御 : 茅山教掌教#Y诸葛糊涂#n因醉心炼丹引发的一场浩劫，你敢挺身而出为挽救茅山教出一份力吗？
【寒假】勇战魔王 : 魔王洞窟小妖头目遭到茅山教徒偷袭死伤无数，嗜血魔王为帮手下报仇，亲自前来茅山。一场腥风血雨的打斗即将上演。
茅山教反击战斩妖除魔 : 寒假活动第一阶段活动，妖魔大举进攻茅山教，茅山教徒们英勇反抗，怎料敌众我寡，败下阵来，望各位道友前往相救。
茅山教防卫战携将上阵 : 茅山教掌教#Y诸葛糊涂#n因醉心炼丹引发的一场浩劫，你敢挺身而出为挽救茅山教出一份力吗？
任务卷轴・力破千钧 : 完成相应目标后可以获得奖励。
【圣诞】苹果送福 : 叮叮当，叮叮当，铃儿响叮当……圣诞节的钟声已经响起，大家快把祝福送满全城吧！
【圣诞】仙兽赐福 : 在这一年一度的圣诞之际，仙兽们被这喜庆的气氛所感染，纷纷下凡赐福了！
【元旦辞旧迎新活动】 : 【元旦辞旧迎新活动】在活动期间均可参加。#R(每天可获得20场战斗的奖励)#n
【吉祥赐福】 : #Y吉祥宠#n正在天墉城的某处发放赐福丹呢，大家赶紧去寻找它们吧！招财纳福、无限好礼等你来拿！
【迎新年】好礼相送 : 新年到，好礼到！春节积分抽奖大礼不断，你还在等什么呢？！
【迎新年】驱逐年兽 : 中洲大陆各地的居民们都在庆祝新年，不料大批年兽入侵中洲，快去消灭年兽保卫家园吧！
【迎新年】喜迎新春 : 新春佳节同庆贺，团团圆圆喜美满，#P活动大使#P正在收集#R酒心年糕#n，你若提交#R酒心年糕#n给#P活动大使#P便可获得丰厚奖励。
【迎新年】万家灯火 : 中洲大陆各地的居民们都在庆祝新年，各地都有大量的灯笼，快去点亮灯笼吧！
【迎新年】灶神赐福 : 灶神大人受玉皇大帝所托下凡人间，为大家带来了新一年的祝福，祝大家身体健康，万事如意！
【迎新年】吉星送喜 : 新年到了，吉星给大家准备新年礼物啦！
【元宵节】欢乐猜灯谜 : 元宵到，欢乐闹，灯谜多多显智慧，快去找#Y元宵精灵#n猜灯谜吧，猜对了有不少奖励喔！
【元宵节】喜庆送汤圆 : 元宵之日，阖家团圆，正是吃汤圆的好日子。#P活动大使#P准备了很多很多的汤圆，准备送给各地的居民。快去帮忙送汤圆吧！
【情人节】爱意飘飘 : 朵朵玫瑰的祝福，颗颗幸运星的环绕，在这充满爱的日子里，让好心情找到你，祝大家情人节快乐！
【情人节】玫瑰寄情 : 幸运花和幸福花都可以给你带来好运，赶紧行动吧！
【情人节】寄托姻缘 : 好人有好报，快加入这幸福的氛围中帮助他人寻找一份缘分吧！
【愚人节】宝箱大冒险 : 愚人宝箱大冒险，愚人还是被愚，你有勇气来参与吗？！
【愚人节】属性变变变 : 愚人卡，随心变。今天，你变了吗？
【愚人节】舞会变变变 : 希望大家都能参加变装舞会，快快乐乐度过愚人节！
【活动】清明祭扫 : 清明节是中国民间传统节日，是重要的“八节”（上元、清明、立夏、端午、中元、中秋、冬至、除夕）之一，一般是在公历4月5号前后，节期很长，有10日前8日后及10日前10日后两种说法，这近20天内均属清明节。
【指引】学习引灵幡技能 : 学习如何使用引灵幡技能，此技能可在战斗中依据玩家的选择发挥神奇的效果。
【植树节】绿化中洲 : 植树节任务，帮助#P活动大使#P完成绿化中洲大陆任务，可以得到奖励，完成的轮次越多获得的奖励越丰厚。
【七周年】真情红包 : 奉#Y鸿钧老祖#n之命，#Y吉祥宠#n正在天墉城的某处发放真情红包呢，大家赶紧去寻找它们吧，无限好礼等你来拿！
【七周年】喜迎周年 : 《问道》七周年之际，鸿钧老祖派各路仙兽纷纷下凡赐福了！
【七周年】一战到底 : 鸿钧仙宠奉鸿钧老祖之命，特前来祝贺《问道》七周年之喜，现已在#Z天墉城(257,199)#Z周围接受大家的挑战，挑战成功的人可以获得丰厚的奖励。
【七周年】天降洪福 : 恭喜你意外的收到一份玉帝赐予的天降洪福大礼，请速去接受挑战。
【七周年】普天同庆 : 玉帝之女找到了其如意郎君，正在#R偶数#n线#Z天墉城#Z举办超豪华#Y神兽游行队伍#n巡游呢，大家快来凑热闹吧，希望在欢度周年庆之余给你带来一份意外的惊喜！
【七周年】莲灯祈福 : 《问道》七周年之际，#P杨镖头#P心事重重，道友们快去看看怎么回事吧！
【封神榜】梦入封神 : 【引子】时间流逝中，封印慢慢减弱。封存了数千年的历史，正在慢慢揭开神秘的面纱。
【封神榜】四门绝阵 : #R朝歌#n虽然看起来一片歌舞升平，可在有心人眼里暗涌已起，风云将变。#Z奈何桥#Z的#P孟婆#P愿意随时帮你进入这奇幻的封神世界。
【活动】寻找九子 : 活动期间所有等级达到40级的玩家可以前往#Z天墉城#Z找寻龙生九子，战胜他们后即可完成任务。战胜九个不同的九子即算完成一轮任务，在规定的时间内完成的轮次越多奖励越丰厚！
【封神榜】妖狐夺舍 : 西伯侯金玉良言，苏护终允献女朝商。轩辕坟三妖正待良机，此行恐有诸多变故。#Z奈何桥#Z的#P孟婆#P愿意随时帮你进入这奇幻的封神世界。
驱鬼避凶 : 接受茅山道士的指引驱除中洲四处游荡的鬼魂，保护中洲的安全。
勇闯万妖窟 : 万妖窟内妖魔横行，无数的妖魔守护着抢夺来的神兵利器和奇珍异宝，勇士们可从#Z十里坡|十里坡（236,180)#Z进入万妖窟斩杀妖魔。
蟠桃园争夺战 : 在蟠桃园战场帮助你的门派获取蟠桃园争夺战的胜利。
【封神榜】苏护献女 : 崇侯虎虽受袭败退，竟有其弟崇黑虎带军助阵。崇黑虎勇猛善战，犹有诸般手段，此番北伯冀州对战，胜负犹未可知。#Z奈何桥#Z的#P孟婆#P愿意随时帮你进入这奇幻的封神世界。
【封神榜】冀州之战 : 苏护反商，纣王命北伯侯、西伯侯挥师冀州。商军大将者众，一场大战爆发在即。#Z奈何桥#Z的#P孟婆#P愿意随时帮你进入这奇幻的封神世界。
封神随机任务 : 参与封神剧情的过程中有几率获得的随机任务，完成随机任务即可获得大量奖励！#Z奈何桥#Z的#P孟婆#P愿意随时帮你进入这奇幻的封神世界。
【活动】抓捕烂赌鬼 : 近来中洲各地出现了很多道行高深的烂赌鬼，他们导人参赌，好多百姓人家因此家破人亡，快去消灭他们吧。
【儿童节】消失的糖果 : 儿童节到了，#Y活动大使#n给天墉城的小朋友们准备了各式各样的糖果，谁知可恶的妖魔趁大使不注意，将所有的糖果都偷走了，希望各位道友协助#Y活动大使#n将糖果找回来，让孩子们过一个愉快的儿童节。
地府・还魂 : 地府中流浪着许多混混僵僵的亡魂，带他们还魂，即可获得无上功德。
地府・转生 : 地府中流浪着许多混混僵僵的亡魂，带他们去六道轮回投胎，即可获得无上功德。
【活动】天降好礼 : 众道友修道勤恳，上天特降好礼以兹鼓励。
【劳动节】劳动最光荣 : 劳动节到了，天墉城城区的地面出现了许多裂缝和杂草，各位道友行动起来把天墉城翻新一遍，体会劳动的快乐。
【端午节】端午欢乐粽 : 端午节为每年农历五月初五，又称端阳节、午日节、五月节等；端午节是中国汉族人民纪念屈原的传统节日，更有吃粽子，赛龙舟，挂菖蒲、蒿草、艾叶，薰苍术、白芷，喝雄黄酒的习俗。
【端午节】喜迎欢乐粽 : 端午节为每年农历五月初五，又称端阳节、午日节、五月节等；端午节是中国汉族人民纪念屈原的传统节日，更有吃粽子，赛龙舟，挂菖蒲、蒿草、艾叶，薰苍术、白芷，喝雄黄酒的习俗。
阵型修炼 : 阵型乃乾坤老祖遗留下来的上等用兵之法，完成师尊的历练，可以在阵型的修行上更进一步。
天鉴神兵 : 道法自然，天道酬勤，在鉴定装备时你将得到意想不到的效果。
寻找高级首饰材料 : 完成龙女的委托，可以将首饰从149级提升至150级。
【七周年】神兽下凡 : #R超级鸿钧神石#n是修筑七周年祭天石柱的必需品，#R鸿钧神石#n与#R百变盒#n在炼丹炉中炼化可获得，将其交与#Y活动大使#n即可贡献一份力量，同时获得丰厚奖励！
【七周年】梦回封神 : 盘古生太极，两仪四象循。封神世界众妖自觉前生无命封神，如今竟将天墉城原貌复原，在那座虚假城池中大胆造次封神，众道友速去除魔卫道吧！
【七周年】星君历练 : #R【七周年】星君历练#n已经开启，在此期间，所有的#Y星宿#n均会出现在天墉城，活动期间其它地图将不再出现星宿，期间还会有#R8位#n#Y鸿钧神使#n造访，更有超值惊喜赠送！
中洲争霸战 : 茫茫中洲，群雄争霸！谁能统领中洲，数风流人物，还看今朝！
【中洲争霸战】建筑升级 : 在中洲争霸战中，占领城市后，通过完成该任务使城市中的建筑升级！
七星聚会挑战 : 传奇名局显现云霄宫，道友可到#Z云霄宫#Z的#P七星战神#P处了解七星聚会挑战！
人宠合体 : 学习人宠合体技能的必经之路，通过考验后可以学习人宠合体技能。
【天降神石】嘲风星图 : 天降神石，九子应劫。被封印千年的#Y嘲风#n，究竟有着什么样的故事呢？
【天降神石】囚牛星图 : 天降神石，九子应劫。被封印千年的#Y囚牛#n，究竟有着什么样的故事呢？
【天降神石】狴犴星图 : 天降神石，九子应劫。被封印千年的#Y狴犴#n，究竟有着什么样的故事呢？
【天降神石】睚眦星图 : 天降神石，九子应劫。被封印千年的#Y睚眦#n，究竟有着什么样的故事呢？
【天降神石】蒲牢星图 : 天降神石，九子应劫。被封印千年的#Y蒲牢#n，究竟有着什么样的故事呢？
【天降神石】貔貅星图 : 天降神石，九子应劫。被封印千年的#Y貔貅#n，究竟有着什么样的故事呢？
【天降神石】霸下星图 : 天降神石，九子应劫。被封印千年的#Y霸下#n，究竟有着什么样的故事呢？
【天降神石】饕餮星图 : 天降神石，九子应劫。被封印千年的#Y饕餮#n，究竟有着什么样的故事呢？
【天降神石】鳌鱼星图 : 天降神石，九子应劫。被封印千年的#Y鳌鱼#n，究竟有着什么样的故事呢？
元婴（血婴）修炼时间 : 任务介绍：在元婴（血婴）修炼时间内杀怪，元婴（血婴）可以获得3倍的经验奖励。
【活动】驱鬼避凶 : 接受茅山道士的指引驱除中洲四处游荡的鬼魂，保护中洲的安全。
【指引】天降神石 : #R神石#n乃九子的化身，拥有点亮星宿机关天赋的使命。快随我一起来挖掘神石的奥秘吧！
【父亲节】父爱如山 : 一日为师，终生为父！父亲节到了，快从#P活动大使#P处把礼物送往各自门派师尊处吧！
【母亲节】慈母之爱 : 慈母手中线，游子身上衣。
【暑假】仙女奇闻 : 天宫派遣七个仙女来到中洲大陆，仙女们带来了各种有趣的听闻和奇幻的法术，道友可将其记录成文，以供后人参考。
【暑假】仙女试炼 : 小仙女生性顽皮，爱舞刀弄枪，来到中洲大陆后自然也是闲不住，因此特邀众道友一起切磋技艺。
【暑假】仙女送福 : 仙女们来到中洲大陆，决定送上自己的祝福给中洲大陆的居民，顺便帮助居民们解决一些琐事。但是中洲居民人数众多，仙女们忙不过来，特别邀请众道友一起来帮忙。
【暑假】异兽选美 : 暑假到来了，七仙女之一的大仙女来到来中洲大陆，她希望带一只中洲异兽前往天宫陪伴左右，特别举办异兽选美大赛，大家积极参与#R暑假活动#n即可获得选票，将获得的选票投给异兽可获得大量的数值奖励。暑假活动结束时投了选票给获得最高选票宠物的玩家，可抽取变异宠物大奖，投的票数越高获得大奖的概率越高，赶快来参加吧！
【暑假】仙女赏花 : 二仙女在天宫时酷爱赏花，来到了中洲大陆后无处赏花，这着实让二仙女有些烦闷。因此特意委托#Y活动大使#n号召众道友在轩辕庙种植鲜花，一来缓解水土流失，二来满足二仙女赏花的私心。前往轩辕庙种花的途中有几率遇到盗宝飞贼，打败他们后可以获得商城道具。
【转世】灵物转世 : 普华天尊念你刻苦修行，特带你领略法宝更加高深的修炼办法。
【国庆节】天赐神宠 : 时逢国庆节庆，天墉城迎来了各路神仙下凡赐福，在活动大使处提交他们所喜爱的百宝锦囊，就有机会获得赢得神仙亲睐，获得重奖！
【教师节】师门试炼 : 师者，所以传道授业解惑也。各门派师尊已命各师门陪练在#Z天墉城(257,199)#Z周围接受大家的挑战，挑战成功的人可以获得丰厚的奖励。
【国庆节】仙人指点 : 时逢国庆节庆，天墉城迎来了各路神仙下凡赐福，找到隐藏在天墉城的南斗六星君，接受他们的指点吧。
【国庆节】与仙同乐 : 时逢国庆节庆，天墉城迎来了各路神仙下凡赐福，找到在天墉城中的“福、禄、寿、喜”四位神仙，向他们讨要礼物吧！#R（各路神仙将在天墉城随机出现，四处走动。）#n
【国庆节】真假仙人 : 时逢国庆节庆，天墉城迎来了各路神仙下凡赐福，在风月谷和轩辕庙出现了大量的真假仙人，快去分辨他们吧。
【暑假】仙女授道 : 众仙女在天宫时常能学习修道之术，因此在修道方面也有自己独特的见解。她们希望将自己所学传授给中洲大陆的修道之士，但是修道需要缘分，因此特意委托活动大使寻找有缘人。
【中秋节】玉兔送礼 : 中秋节，中国传统节日之一，为每年农历八月十五，传说是为了纪念嫦娥奔月。
【七夕】保卫鹊桥 : 听闻#Y王母娘娘#n近日性情不定，派大量#Y天兵#n与#Y天将#n下凡欲阻止喜鹊飞上银河搭桥，让#Y牛郎#n与#Y织女#n无法相会，望各位道友拔刀相助，将他们击退。
【爱我中华】击杀倭奴 : 爱我安宁，解救百姓。如今#Z东海渔村#Z、#Z无名小镇#Z正在遭受倭奴侵袭，正在肆意烧杀抢掠，各位仁人义士速去剿之，解救百姓。成功解救百姓，还有机会触发与#Y倭夷#n、#Y倭王#n的战斗，胜利后还有机会获得意想不到的惊喜。活动所有双倍、三倍奖励均无效。
【暑假】仙宠送礼 : 仙女们的坐下#Y仙宠#n正在天墉城的某处发放福利签呢，大家赶紧去寻找它们吧！无限好礼等你来拿！
千宝宫 : 传说千宝宫内藏有大量的宝物，需好友齐心协力一同前往方可。
【新手】1-9级新手任务 : 新的问道，新的开始。看似平静的揽仙镇和中洲大陆，这是暴风雨前的宁静么？
【活动】输送物资 : 中洲妖魔活动猖獗，李总兵号召天下道友共御强敌，一场艰苦的战斗即将展开。
【今天我是小寿星】 : 今日你是小寿星，可以去找多闻道人免费试穿所有的时装。
【新手】30-39级新手任务 : 门派比武大会突然展开，还不能熟练师门技能的你，已经做好了迎接挑战的准备吗？
【新手】20-29级新手任务 : 拜入了师门的你，为了提升自己的能力，也为了调查家中变故的缘由，展开了艰辛的修道之路。
探索世界任务 : 探索世界地图事件。
【指引】法宝转世系统 : 法宝乃灵物，吸取天地之灵气，修炼方式无止境，灵物的境界也是常人无法企及的。
【新手】10-19级新手任务 : 拜入了师门的你，为了提升自己的能力，也为了调查家中变故的缘由，展开了艰辛的修道之路。
相逢意气为君饮 : 一斗新丰美酒价值十千钱，如若能有缘和道友共饮一杯，无须经过长期交往，只要相逢片刻，攀谈数语，就可以彼此倾心。
【指引】中洲争霸建筑升级 : 拥有城市所有权区组可以在本区组为城市中的建筑做升级任务。
【指引】奇宝斋系统 : #R奇宝斋#n是问道官方所认可的游戏线下交易平台。为了满足玩家线下交易的需求，同时使大家远离骗子，并打击盗号者的销赃行为，从而应运而生的。
奇宝斋之星 : 每天浏览奇宝斋都会有意外惊喜哦。
【领取】奇宝斋之星奖励 : 每天浏览奇宝斋都会有意外惊喜哦。
【新手】40-49级新手任务 : 门派大战未起，青袍祸乱又生；为了查清青袍门的歹人，去一探他们的虚实。
襄助道友驱邪灵 : 众道友们在修道之途摒弃邪念追求至善，其间所摒弃的邪念却日积月累凝聚成邪灵，若不早日驱除邪灵将危害天下苍生。
【新手】70-79级新手任务 : 至门派比武大会一战之后，你经常出现#R头疼欲裂#n的感觉，这到底是怎么一回事呢？
【新手】50-59级新手任务 : 门派比武在即，为了学习到更加高深的道法，为了血海深仇，你一定要赢。
【新手】60-69级新手任务 : 门派比武大会已经结束了，但是其中似乎蕴含了很深的阴谋，你能发现线索，调查清楚吗？
【重阳节】重阳祈福 : 重阳节，农历九月初九，“九九”谐音是“久久”，有长久之意，人们常在此节期间祈福与推行敬老活动。
【重阳节】敬老尊贤 : 重阳节，农历九月初九，“九九”谐音是“久久”，有长久之意，人们常在此节期间祈福与推行敬老活动。
【光棍节】妖怪不过光棍节 : 妖怪们都成双成对的，连光棍节也不过，以后繁殖出更多的妖怪来危害世人可怎么办。
【光棍节】真爱祝福 : 世界上总是有那么多的好人，却找不到自己的真爱，让我们去祝福他们找到自己的真爱吧！
【指引】坐骑天赋系统 : 开启坐骑的#R助阵#n天赋后，它就可以陪同你一起进入战斗。
【功能】重置加点 : 你学会了加点和相性功能，现在可以找相关师傅重置加点了。
【指引】学习物理法术合击 : 在PVP战斗中，大家可以使用物理法术合击技能，该任务将指引你如何学习和使用物理法术合击技能，以发挥更强的战斗力。
【封神榜】杀子诛妻 : 纣王荒淫无道，听信妇言，国政颠倒，诛妻杀子，叁纲已绝！#Z奈何桥#Z的#P孟婆#P愿意随时帮你进入这奇幻的封神世界。
【新手】领取装备v4 : 长老对于初入师门的你青睐有加，特给于你一套全新装备，快去领取吧。
【元旦】共襄盛举 : 天墉城居民又迎来了一个丰收年，为了感谢一直帮助居民的东海龙王，居民们决定送些礼物前往拜访龙王，特邀请众道友帮忙运送。#R当天完成6次运送任务的玩家，可在20：00-22：00挑战贪婪魔王，胜利后可以获得丰厚的数值和道具奖励。#n
【圣诞节】拯救圣诞雪人 : 在圣诞来临之际，#P活动大使#P辛辛苦苦在#Z天墉城#Z布置了好多雪人，没想到窜出来好多#R捣乱的火苗#n把雪人们都融化了。道友们快帮帮活动大使吧！
【圣诞节】马虎的圣诞老人 : 圣诞老人真是马虎，匆匆忙忙的就准备好了圣诞礼物，却没发现装礼物的袋子上破了一个洞，飞到哪礼物就洒到哪，不过倒是给道友们带来了不少福利！
【封神榜】狐妖成妃 : 武成王黄飞虎已经允诺护送苏妲己入朝歌，但如今的苏妲己已是狐妖化身。送妖入宫，成汤天下又将如何呢？#Z奈何桥#Z的#P孟婆#P愿意随时帮你进入这奇幻的封神世界。
【封神榜】妲己化妖 : 朝歌之行，坎坷多事。狐狸精之战，苏护心有余悸。只盼早日平安到朝歌，献了女儿，赎了罪！#Z奈何桥#Z的#P孟婆#P愿意随时帮你进入这奇幻的封神世界。
挑战紫微星君 : 紫微星有“斗数之主”之名，又称帝星之称，乃北斗七星之主。道友若能得他指点，必定能大幅提升道法，增进道行！此乃千载难逢的机会，道友万不可错失良机！
【封神榜】拒谏杀忠 : 狐妖妲己妖娆百媚，迷惑君心，残害忠良；纣王昏庸无能，荒淫无道，残暴享乐！成汤八百年基业浮现断送之兆！#Z奈何桥#Z的#P孟婆#P愿意随时帮你进入这奇幻的封神世界。
【体验服】升级元宝送不停 : 关于体验服玩家所能获得的福利和奖励的相关说明。
【体验服】冲成就领大奖 : 问道体验服独特的冲成就得大礼活动。
古树仙境 : 为了给古树仙贺千年大寿，众仙子欲在古树仙境与天下道友斗法助兴。与她们过招对各位道友提升道法多有裨益，此乃千载难逢的机会，各位道友万不可错失良机。
桃花谷 : 桃花谷乃人间仙境，但近日妖气弥漫，不知是何原因，烦请各位道友速速前去查看。
【副本挑战】徒劳无功 : 天下修道者甚多，但道法高超者却鲜有耳闻。道友若能在#R烈火涧#n副本与#R赤焰兽#n战斗中，杀死#R30#n只小怪的情况下获得战斗胜利，赤灵尊神将重重有赏！
【副本挑战】四回屠魔 : 天下修道者甚多，但道法高超者却鲜有耳闻。道友若能在#R兰若寺#n副本与#R黑山老妖#n战斗中，#R4#n回合内(包括#R4#n回合)获得战斗胜利，赤灵尊神将重重有赏！
【副本挑战】无力回天 : 天下修道者甚多，但道法高超者却鲜有耳闻。道友若能在#R桃花谷#n副本与#R九黎魔将#n战斗中，让#R上古尸魔#n无法复活其他怪物，赤灵尊神将重重有赏！
【副本挑战】休想复生 : 天下修道者甚多，但道法高超者却鲜有耳闻。道友若能在#R古树仙境#n副本与#R莲花仙子#n战斗时，莲花小仙复活次数为#R0#n的情况下结束战斗，赤灵尊神将重重有赏！
杀气腾腾 : #P蒙面#P已帮你将愤怒和怨恨凝聚成足够的杀气，你感觉一股浓浓的杀气从心底升起！
【骏马迎春】瑞雪祈福 : 瑞雪兆丰年，天墉城现已变成了一片银装素裹之景象，想不想叫上三五个好友一起把#R天墉城#n的#Y雪球#n堆成#Y雪人#n呢？堆好后还有机会获得意想不到的惊喜。活动所有双倍、三倍奖励均无效。
【骏马迎春】奇珍异宝 : #R福到#n是过年时家家必备的祈福祥物，#R福#n与#R锦囊#n在炼丹炉中炼化可获得，将其交与#Y活动大使#n即可为自己及家人在来年多祈一份福，同时获得丰厚奖励！
【骏马迎春】新春献礼 : 雪片纷纷凝瑞，马蹄得得报春；红包年年压岁，鸿钧朝朝送福！马年春节已经来临，上百匹#R吉祥溜溜马#n在天墉城与众道友一同迎春！马儿们为众道友准备了大量的#R红包#n，若能找到#R吉祥赤天马#n还会有额外的惊喜，大家赶快去领取吧！
【情人节】缘来是你 : 爱是天时地利的迷信，有缘的人啊，原来你也在这里。
【情人节】天佑有情人 : 风月谷景色旖旎，恰逢佳期，有情之人皆相约于此，你侬我侬，缠绵缱绻，诉尽相思。可恨妖物竟见不得这般美好，从各路闻风而来，密谋偷袭众情侣！如此良辰，怎容邪孽作祟！
【元宵节】制花灯闹元宵 : 元宵节来临之际，天墉城准备举办一场花灯大会，但是制作花灯的材料不足，各位道友们快去帮帮#P活动大使#P收集材料吧！
【骏马迎春】年兽入侵 : 中洲大陆各地的居民们都在庆祝新年，不料大批年兽入侵中洲，快去消灭年兽保卫家园吧！
【骏马迎春】迎春序曲 : 新年到了，奉鸿钧老祖之命，活动大使给大家准备新年礼物啦！
【寒假】天墉来客 : 又是一年寒假到，天墉城迎来了一批莘莘学子前来观光，好不热闹。
【骏马迎春】五福临门 : 中洲大陆各地的居民们都在庆祝新年，相互祝福春节快乐，五福临门！
【龙血之精】 : 道高一尺，魔高一丈，妖界如今又在蠢蠢欲动，一场空前绝后的人魔大战在所难免。惊天魔魂如今已出关，即将诅咒人间。望广大英雄豪杰前来击之，阻止其祸害人间！
【骏马迎春】战马出征 : 新春之际，战马现已在#Z天墉城(248,202)#Z周围接受大家的挑战，挑战成功的人可以获得丰厚的奖励。
【寒假】凝聚法术 : 2014年寒假活动之一，让您轻松度过愉快的感受假期中的中洲世界。
【寒假】画中寻人 : 2014年寒假活动之一，让您轻松度过愉快的感受假期中的中洲世界。
【寒假】护送密件 : 寒假来了，天墉城多了许多的观光游客，许多妖魔也趁机混入其中，这给#Z天墉城#Z南北城门之间的密件运送带来了很大的麻烦。因此#P天墉城守卫#P召集众道友帮忙天墉城士兵护送密件。
【寒假】饱读诗书 : 寒假生活多姿多彩，饱读诗书活动让大家在游戏中学习古诗文，轻松学习快乐游戏。
【寒假】食全食美 : 寒假生活多姿多彩，食全食美活动教大家学习烹饪知识，了解中洲大陆的美食。
【寒假】烹饪菜肴 : 烹饪菜肴可是个大学问，必须亲力亲为才行啊。
【寒假】排忧解难 : 来到中洲游玩的游客好像遇到了不少困难，你能帮帮他们吗？
【活动】封神比武 : 中洲大陆各大门派弟子身怀绝技，斩妖除魔各显神通。鸿钧老祖特设封神比武，检验中洲勇士的能力。
封神比武固定队伍 : 只有相约为固定队后才可以进入封神战场进行比赛。
老兵不死 : 欢迎您来到问道，我们为您准备了两份惊喜！
老兵不死积分大礼 : 你可以使用#R老兵不死活动积分#n至#P问道缘大使#P处或者使用#R问道嘉年华积分#n至#P董老头#P处参加抽奖。
【老兵不死】相约问道 : 老兵不死活动，让你们相约问道！赶紧去找回你们的昔日伙伴吧！
【时事】时事预测 : 正所谓“风声雨声读书声，声声入耳；家事国事天下事，事事关心！”，道行高深之士往往能窥视天机，预测未来！#R时事预测#n活动无疑是众道友衡量自己预测能力的最佳平台！
帐号限制交易 : 由于你的帐号在游戏中涉嫌非法操作，已被#R限制交易#n处理。GM已在核查信息，核查完毕后将进行相应的处理。
【植树节】种树抗沙 : #Y轩辕庙#n水土流失，长期遭受沙尘的袭击，众道友在植树节来临之际一起种树抗沙，为轩辕庙增添一片绿色。
限制交易 : 由于你的帐号在游戏中有部分物品归属存在异议，已被#R限制交易#n处理。GM已在核查信息，核查完毕后将进行相应的处理。
【愚人节】百变怪来袭 : 大量百变怪入侵天墉城，百变怪最喜欢用变身之术糊弄人，只有以变克变方能制胜。
【儿童节】元灵巡游 : 儿童节到了，元灵也来到天墉城、揽仙镇和东海渔村游玩，大家快趁这个机会跟他们玩游戏吧。
【八周年】天马行空 : 中洲大陆各地的居民们都在庆祝《问道》八周年，大批天马也下凡中洲庆周年！
【八周年】中洲共庆 : 问道八周年来临之际，中洲大陆普天同庆，不管百姓神仙均欢天喜地迎庆典。但喜庆的日子终究还是日子，欢乐的欢乐犯愁的依旧犯愁。如期佳期，众道友何不与欢乐的人分享欢乐，为犯愁的人送走愁容？
【端午节】粽叶飘香 : 粽子是端午节的节日食品，古称“角黍”，传说是为祭投江的屈原而开始流传的。
【八周年】周年大礼 : 值此《问道》八周年纪念日到来之际，爱嬉皮捣蛋、爱撒娇的小师妹们都来到#Z天墉城#Z派发#R八周年红包#n！
【八周年】师妹情深 : 你是否还记得昔日谆谆教导的长老？是否还记得爱嬉皮捣蛋、爱撒娇的小师妹？如若无法忘却，就趁八周年大喜之际回师门看望他们吧！
【八周年】元灵贺喜 : #R驱邪护符#n是八周年纪念宠#R小师妹#n的护身符，#R护符#n与#R老酒#n在炼丹炉中炼化可获得，将其交与#Y活动大使#n即可为自己及家人祈求安康，同时获得丰厚奖励！
【八周年】护送师妹 : 值此《问道》八周年之际，各门派#R小师妹#n们积极下山帮助#P活动大使#P筹备庆典！然毕竟年纪尚小，虽下山不久却十分想念长老，因此#P活动大使#P召集众道友帮忙护送#R小师妹#n回山看望长老！
【八周年】妖兽入侵 : 八周年来临之际，#R三祥五福兽#n下凡到天墉城给各位道友送祥福，但却被一群企图复苏魔王的小妖盯上了。各位道友，时间紧迫，快快到天墉城消灭这些入侵的小妖吧！
【八周年】同门切磋 : 各门派小师妹道法如今已有所成，此次欲趁问道八周年庆典之际下山与各位道友比武切磋，以验证自身的道法修为。各派宗主对她们恩宠有加，所传道法自然不可小觑。众道友可别被她们可爱娇气的外表所蒙骗，以致一败涂地。
【母亲节】温暖母爱 : 母亲节到了，道友们为中洲大陆的母亲们献上一束美丽的鲜花，回报母亲无私的爱。
【母亲节】献花 : 为中洲大陆的母亲献花，送上母亲节的祝福。#R（带上娃娃参战将获得更丰厚的奖励）#n
【清明节】纸鸢纷飞 : 清明时节，碧空万里，慧风和畅，正是放飞纸鸢的最佳时节！
【老兵不死】老兵的试炼 : 老兵不死，只是凋零！#Y问道缘大使#n对你回归之后的能力有所怀疑，向其证明你的实力吧。
曾记否 : 曾记否，丫丫小髻绿青衣，暖暖轻语甜酒窝；曾记否，揽仙镇里寻仙路，莲花湖中惊鸥鹭；曾记否，仙府拜师共修道，许我此生同成仙？昔日一别百余载，只剩红袖独自飘。
【活动】游城 : 通过游城，道友们可以更加团结，团结就是力量！
斗宠大会 : 东海#Y龙王#n，邀天墉城众道友斗宠，你的宠物能脱颖而出，获得龙王的奖赏吗？
【战棋】体验活动 : 打开#R互动中心#n点击#R问道战棋#n按钮进入。
后羿射日・十个太阳 : 介绍中国经典神话故事后羿射日的故事。
后羿射日・小惩大诫 : 介绍中国经典神话故事后羿射日的故事。
后羿射日・下定决心 : 介绍中国经典神话故事后羿射日的故事。
后羿射日・大功告成 : 介绍中国经典神话故事后羿射日的故事。
后羿射日・不堪重负 : 介绍中国经典神话故事后羿射日的故事。
运筹帷幄比赛固定队伍 : 只有相约为固定队后才可以报名和参加运筹帷幄比赛。
后羿射日・寻找祸源 : 介绍中国经典神话故事后羿射日的故事。
后羿射日・为民除害 : 介绍中国经典神话故事后羿射日的故事。
后羿射日・保护族人 : 介绍中国经典神话故事后羿射日的故事。
后羿射日・恢复平静 : 介绍中国经典神话故事后羿射日的故事。
【六星成就】天鹅肉 : 揽仙镇外的蛙大、蛙二、蛙囡和蛙细仔告诉你一个关于天鹅肉的秘密，根据它们所言，秘密藏在一首诗当中。解开诗句中的谜题，帮它们找到天鹅肉。
【六星成就】帮助乞丐 : 不曾想天墉城的#Y乞丐#n竟然如此仗义，自己享福不忘兄弟，难得可贵。身为修道中人，怎么能袖手旁观呢，好事做到底，帮帮他们吧！
后羿射日・斩草除根 : 介绍中国经典神话故事后羿射日的故事。
【六星成就】帮助乞丐 : 不曾想天墉城的#Y乞丐#n竟然如此仗义，自己享福不忘兄弟，难得可贵。身为修道中人，怎么能袖手旁观呢，好事做到底，帮帮他们吧！
新30环连环 : 新30环连环任务为单人的修炼任务，玩家花费#R12天的位列仙班时间#n后可以领取任务。玩家可以在2个小时内完成30个刺激精彩的任务，每个任务都可以获得数值奖励和任务积分，同时还有几率获得#R商城道具#n。#R任务积分#n可以在#P问道活动大使#P处兑换#R天道神符#n商城道具。
【封神榜】姬伯朝商 : 皇后割目含冤而死，纣王恐东伯侯闻知而起兵反乱，于是夜召佞臣费仲商量对策。#Z奈何桥#Z的#P孟婆#P愿意随时帮你进入这奇幻的封神世界。
【封神榜】哪吒闹海 : 东伯侯之子姜文焕得知父亲姜桓楚被害后，联合南伯侯鄂崇禹之子鄂顺大举二百诸侯之兵反商，玩家奉命前往陈塘关协助李靖阻挡联军。#Z奈何桥#Z的#P孟婆#P愿意随时帮你进入这奇幻的封神世界。
【封神榜】子牙下山 : 龙王之怒还未平息，哪吒又惹石矶下山索命，真是一波未平一波又起啊！#Z奈何桥#Z的#P孟婆#P愿意随时帮你进入这奇幻的封神世界。
【封神榜】绝境营救 : 纣王昏庸残暴，听信妲己妖言，欲杀亲生骨肉，老丞相商容以死相谏！#Z奈何桥#Z的#P孟婆#P愿意随时帮你进入这奇幻的封神世界。
疯狂天缘令 : 拥有该任务时，完成#R日常任务#n后，在#P白邦芒#P处兑换奖励时可获得额外的20%的数值奖励。
YY回归活动奖励 : 乐豆豆给予回归玩家的装备和宠物奖励。
【七夕节】共搭鹊桥 : 纤云弄巧，飞星传恨，银汉迢迢暗度。柔情似水，佳期如梦，忍顾鹊桥归路。
【感恩父亲】温馨父爱 : 还记得你刚出世，来到揽仙镇见到的那位慈祥的仙者吗？每次无奈死亡后，被传送至安全区的守护者吗？他是你来到这个世界后的首位鉴证人，父亲节之际，快去#Y多闻道人#n处对其探望，表示感谢吧。完成任务时可拥有供世界玩家鉴证你对父亲的感恩之情的机会，每个整点会抽取#R1名#n发送祝福较多的玩家，赠予#R孝子#n限时30天的称谓奖励。
【中华崛起】抗击倭寇 : 女娲娘娘的水晶球探测到大批倭寇昨夜已从#R东海渔村#n悄悄登陆，现已攻占了#Z地府#Z，我中洲大地之亡灵即将永无安宁。各位仁人义士速去剿之。成功剿灭倭寇后还有机会获得意想不到的惊喜！活动所有双倍、三倍奖励均无效。
延迟金钱奖励 : 为协助反外挂调查，老君限制不符合一定条件的玩家在以下系统中获得的金钱奖励不能马上获得。
天道神符兑换 : 开启道具兑换模式后，完成#R除暴、降妖、伏魔、仙界通缉、飞仙渡邪#n时，将不获得游戏币奖励。获得的游戏币数值将记录在此任务中，达到一定数量后，可前往#P李总兵#P、#P通灵道人#P、#P陆压真人#P、#P玉鉴上人#P、#P太玄真君#P处兑换#R天道神符的次数#n。
【暑假】封神竞技积分 : 积极参与暑假活动即可获得封神竞技积分，积分可以兑换经验和道行数值奖励，在所有暑假活动都结束时，本服使用无量心经兑换大量数值奖励次数最多的玩家可以获得#R全新变异宠物独角仙#n。
【暑假】中洲寻令 : 封神令不慎散落入人间，道友如有找到就交还给活动大使吧。
【暑假】巡视安民 : 各路豪杰皆聚集在天墉城参加封神大会，许多妖怪趁此机会出现在中洲大陆危害苍生，于是活动大使请求众道友到中洲大陆各处巡视，帮助有困难的居民们。
【暑假】封神竞猜 : 16路封神豪杰聚首天墉城比武争冠，成为世间众人聚焦之热点。活动大使同步开办竞猜活动，众人可选择各路豪杰押注竞猜，押中比武冠军者将可获得奖励。不料妖孽趁机四起危害中洲大陆，并且夺走了押注用的筹码，于是封神比武增添了杀妖夺筹码这一小插曲。
【暑假】封神追捕 : 封神大会正在天墉城举办得如火如荼，但是各路邪恶的妖魔趁机在中洲大陆横行妄为，因此#P活动大使#P特邀众道友帮忙斩妖除魔，维护中洲大陆的安定确保封神大会的顺利进行。同时整个服务器击杀妖魔的总次数到达一定值时，将会引出#Y妖魔大王#n，击败它可获得丰厚的道具奖励。
【暑假】封神狂欢 : 封神大会自然少不了活泼可爱的吉祥宠，陪吉祥宠一起狂欢可以获得丰厚的数值奖励。
【暑假】保卫西瓜 : #Z桃柳林#Z的西瓜成熟了，恰逢封神大会在天墉城召开，居民们决定将西瓜献给各路豪杰品尝，但是将西瓜从桃柳林运送至天墉城路途凶险。因此委托众道友前往#Z桃柳林#Z采摘西瓜并护送至#P活动大使#P处，完成任务后可获得丰厚的奖励哦。
【暑假】擂台封神 : 擂台封神作为本次封神大会的主要活动吸引了不少英雄豪杰参与其中，45分钟内挑战层数最高的队伍可获得丰厚的道具奖励。
【休闲游戏】大鱼吃小鱼奖励领取 : 你玩的大鱼吃小鱼的技术不错，神风上人决定给你一些奖励。
问道塔防・守卫灵塔 : 无数妖魔鬼怪正欲毁坏中洲腹地的上古灵塔，快去守卫灵塔吧！
【休闲游戏】钓鱼奖励领取 : 你钓鱼的技术不错，龟力上人决定给你一些奖励。
工艺技能专精 : 工艺技能博大精深，常人无法精通所有的技巧，只能选择其中一个专精修炼。
更改技能专精 : 工艺技能博大精深，常人无法精通所有的技巧，只能选择其中一个专精修炼。
采集技能升级 : 学习采集技能后，需要提升其技能等级，采集工可根据当前采集技能的等级在相应的地图上进行矿石采集，采集的过程中可以获得熟练度，熟练度用于采集技能的升级。
【教师节】学子献花 : 昔日谆谆教诲，今日句句在耳。往日慈祥的尊容，时时浮现。一日为师，终生为父。教师节来临之际，天墉城中出现了各种花仙，众道友可根据师长的花语来猜对应的花仙。战胜花仙后，回禀师长即可完成任务获得奖励。
【中元节】魂归故里 : 魂魄归去无所依，时至中元回人间。昔日子孙隔生死，愿到故里走一圈。一年一度的中元节已经到来，因地藏王特赦，那些无处安身的游魂野鬼今日可回生前的故里探望。如今他们已在#Z天墉城#Z聚集，各位道友可到#Z天墉城#Z帮助这些#R游魂或野鬼#n实现愿望。
【中秋节】博饼庆中秋 : 博饼是中秋节时的一种大众娱乐活动，用六粒骰子投掷结果组合来决定参与者的奖品。
【新手】84级新手任务 : 五大门派内讧的事已经告一段落，接下来你该何去何从？
【新手】80级新手任务 : 你在无意识的时候误伤了#R五大门派的弟子#n，这场误会该如何消除？
【新手】85级新手任务 : 毒性渐渐在你身上发作，你该如何面对？
【新手】82级新手任务 : 大敌当前！师傅是否能解开你与五大门派之间的误会？你会得到什么样的惩罚呢？
【新手】81级新手任务 : 血月魔族的入侵将会引发第三次仙魔大战吗？在漩涡中心的你又应该如何面对？
【新手】88级新手任务 : 丢失的法宝，和血月魔族重返中洲有着重大关联，必须立刻抢回来。
【新手】86级新手任务 : 连日来服用药物并没有使你的毒性完全根治，出现在中洲的神秘人，他是罪魁祸首吗？
【新手】89级新手任务 : 夺取法宝的行动迫在眉睫，一场争夺战无可避免。
【新手】83级新手任务 : 师傅对你在百花谷误伤五大门派弟子一事已经给出表态，但更大的危机还在后头。
【新手】87级新手任务 : 得知天界中也有血月魔族的奸细的消息，各大门派应该怎么应对？这个奸细又会是谁呢？
【国庆节】众志成城 : 《问道》国庆节期间，大批妖魔涌入各城镇！中洲的道友们应当众志成城，阻止妖魔的入侵！
【国庆节】精兵检阅 : 举国欢腾之际，为振我国威，特举办此次阅兵式。期间或许还能看到我们自己的雄姿。瞧，一列列有型的方阵队即将向我们走来……
【国庆节】全民动员 : 盘古生太极，两仪四象循。封神世界的妖孽掠夺了我们稀有的六阶坐骑、变异和神兽，众道友速去将其夺回，以免妖孽祸害人间。
【国庆节】金秋赐福 : #R国庆蛋糕#n是为了给祖国母亲庆祝生日，玩家可直接使用获得丰厚奖励！也可以与#R水果卡#n在炼丹炉中制作#R水果蛋糕#n，将其交与活动大使将获得更丰厚的奖励！
【国庆节】超凡脱俗 : 俗话说，爱美是女子的天性，一套好看的衣服无疑是每个女子都想要的礼物。小师妹们对国庆节期待已久，众道友可以乘此佳节让她们#R换装#n，满足下可爱的她们。
【国庆节】精英选拔 : #Z天墉城#Z出现一批批#Y恐怖恶魔#n，快将其击杀成为万众瞩目的英雄吧！在#P活动大使#P处购买#R超神符咒卡#n对自己进行变身，进入战场后将有神秘老者相助，同时还可以获得更加丰厚的奖励！#R（拥有超神符咒效果的玩家只能单人进行精英选拔活动）#n
超神符咒 : 封印着超级大BOSS特殊技能的超神符咒，战斗中还能获得神秘老者的鼎力相助，攻无不克，战无不胜。更有丰厚的奖励赠予。平时可以在战斗中孤傲自赏一身魁梧美态，持续变身时间为4小时。
宠物寿命指引 : 当宠物寿命为0时将不会出现在战斗中，使用#R神兽丹#n或#R超级神兽丹#n可以补充宠物寿命。
宠物驯养指引 : 宠物的忠诚度小于等于70时有一定几率不参加战斗，小于等于30时则会离开战场不愿意战斗。
全民PK赛 : 一年一度的全民PK大赛火热开启，比赛中玩家的等级、道行、武学等统一设定，玩家自由选择搭配，完全公平、公正，更有数十万现金等你来拿。还在等什么，快来参与吧！
全民PK热身资格 : 在全民热身赛中，可任意选择宠物、装备、娃娃等，并与其他玩家组队进行PK或挑战#R全民陪练#n。
【中秋节】月满中秋 : #R中秋月饼#n是中秋节传统节日特色食品，玩家可直接使用获得丰厚奖励！也可以与#R老酒#n在炼丹炉中制作#R酒香月饼#n，将其交与活动大使将获得更丰厚的奖励！
【中秋节】玉兔送礼2014 : 中秋节，中国传统节日之一，为每年农历八月十五，传说是为了纪念嫦娥奔月。
【中秋节】拯救玉兔 : 中秋节来临之际！天墉城来了好多玉兔贺中秋，没想到凡间的兔子太调皮，偷走了玉兔带来的月宫胡萝卜。道友们快帮帮饥肠辘辘的玉兔吧！
【中秋节】五福临门 : 中洲大陆各地的居民们都在庆祝中秋节，相互祝福中秋节快乐，五福临门！
禁闭处罚 : 在游戏中存在恶意或违法行为将会受到禁闭处罚，在该状态下禁止在各频道发言。
【副本挑战】八回屠魔 : 天下修道者甚多，但道法高超者却鲜有耳闻。道友若能在#R兰若寺#n副本与#R黑山老妖#n战斗中，#R8#n回合内(包括#R8#n回合)获得战斗胜利，赤灵尊神将重重有赏！
【全民签到】行行出状元 : 活动期间每天完成一系列日常活动即可获得一份大礼。
全民现金大奖 : 已经获得报名资格或报名成功。
【老兵不死】荣耀回归 : 问道#R老兵召回活动#n火热进行中，感谢您对#Y问道#n的支持。
坐骑炼魄 : 坐骑炼魄之术乃仙界绝学。
【国庆节】举国欢庆 : 《问道》国庆节期间，全民打孔，举国欢庆。
【万圣节】不给糖就捣乱 : 万圣节，让我们一起狂欢吧，不给糖就捣乱！
【寒假】训练表现积分 : 中洲勇士全民皆兵，共御强敌！2015年寒假活动之一，夏总兵发出召集令，号召中洲得道人士参加全民大练兵，预防将来出现的强敌。积极参与寒假活动可获得#Y表现积分#n，表现最优秀的玩家可获得#R变异宠物独角仙#n。
【寒假】切磋训练 : 中洲勇士全民皆兵，共御强敌！2015年寒假活动之一，夏总兵发出召集令，号召中洲得道人士参加全民大练兵，预防将来出现的强敌。
【圣诞节】修补雪人 : 活动大使在天墉城布置的雪人似乎缺少了什么，每次堆起后没过多久便会倒下，道友们快帮帮忙吧。
【圣诞节】圣诞礼物 : 圣诞平安夜凌晨过后，活动大使将向各位道友们发放#R圣诞礼物#n！
【寒假】智力训练 : 中洲勇士全民皆兵，共御强敌！2015年寒假活动之一，夏总兵发出召集令，号召中洲得道人士参加全民大练兵，预防将来出现的强敌。
【寒假】武力训练 : 中洲勇士全民皆兵，共御强敌！2015年寒假活动之一，夏总兵发出召集令，号召中洲得道人士参加全民大练兵，预防将来出现的强敌。
【寒假】团队训练 : 中洲勇士全民皆兵，共御强敌！2015年寒假活动之一，夏总兵发出召集令，号召中洲得道人士参加全民大练兵，预防将来出现的强敌。
【寒假】耐力训练 : 中洲勇士全民皆兵，共御强敌！2015年寒假活动之一，夏总兵发出召集令，号召中洲得道人士参加全民大练兵，预防将来出现的强敌。
【元旦】正名之争 : 在我国古代，1月1日又被称为“元朔”、“元春”、“元正”或“元辰”，现在这些精灵大闹天墉城了，要夺回节日之名。
【元旦】烟花驱邪 : 2015年元旦节活动，完成活动大使的任务，驱除出现在中洲世界的邪灵吧。
【感恩节】火鸡大餐 : #R熏烤火鸡#n是感恩节大餐必备的主菜，玩家可直接使用获得丰厚奖励！也可以与#R老酒#n在炼丹炉中制作成#R秘制烤火鸡#n，将其交与活动大使将获得更丰厚的奖励！
神兵利器 : 神兵利器，驰骋中洲。
夸父逐日・创夸父族 : 介绍中国经典神话夸父逐日的故事。
夸父逐日・桃花盛开 : 介绍中国经典神话夸父逐日的故事。
夸父逐日・一统全族 : 介绍中国经典神话夸父逐日的故事。
夸父逐日・蓄势待发 : 介绍中国经典神话夸父逐日的故事。
夸父逐日・奔向隅谷 : 介绍中国经典神话夸父逐日的故事。
夸父逐日・加入部族 : 介绍中国经典神话夸父逐日的故事。
夸父逐日・妖魔四起 : 介绍中国经典神话夸父逐日的故事。
夸父逐日・渭河之水 : 介绍中国经典神话夸父逐日的故事。
夸父逐日・魂断昆仑 : 介绍中国经典神话夸父逐日的故事。
【封神榜】请妖赴宴 : 鹿台竣工完毕，妲己欲邀神仙与纣王取乐；黄飞虎、比干暗地调查妲己身份，盛怒之下，火烧轩辕洞，#Z奈何桥#Z的#P孟婆#P愿意随时帮你进入这奇幻的封神世界。
夸父逐日・黄河龙宫 : 介绍中国经典神话夸父逐日的故事。
【封神榜】文王回周 : 西伯侯姬昌出逃须过五关，纣王得知后派兵追缉。前有守将，后有追兵，文王此行道路坎坷多变。#Z奈何桥#Z的#P孟婆#P愿意随时帮你进入这奇幻的封神世界。
【封神榜】子牙谏主 : 纣王受妲己蛊惑造虿盆继续残害忠良，姜子牙火烧琵琶后登殿谏主。#Z奈何桥#Z的#P孟婆#P愿意随时帮你进入这奇幻的封神世界。
【封神榜】进贡赎罪 : 西岐伯邑考为救西伯侯向纣王进贡，散宜生献计贿费尤。#Z奈何桥#Z的#P孟婆#P愿意随时帮你进入这奇幻的封神世界。
【三羊开泰】美羊迎春 : 新年到了，奉鸿钧老祖之命，活动大使给大家准备新年礼物啦！
【指引】宠物心法 : 宠物#R宠物心法#n已开启，习得#R宠物心法#n的宠物可以使其能力得到更好发挥！
【三羊开泰】一战成名 : 新春之际，战羊们现已在#Z天墉城(248,202)#Z周围接受大家的挑战，挑战成功的人可以获得丰厚的奖励。
【三羊开泰】万事亨通 : #R中国结#n给人以纯朴、吉祥的印象。玩家可直接使用获得丰厚奖励！也可以与#R材料箱#n在万事亨通界面制作并直接提交#R精致中国结#n，提交后可获得丰厚奖励！
【三羊开泰】仙女下凡 : 喜迎新年，王母娘娘特派仙女下凡，与众道友一同庆贺。这次仙女们带着她们特制的#R新年专属服饰#n下凡，道友们快快带上小师妹帮他们#R换装#n吧！
【三羊开泰】福星高照 : 中洲大陆各地的居民们都在庆祝新年，相互祝福春节快乐，福星高照！
【三羊开泰】除夕之战 : 中洲大陆各地的居民们都在准备庆祝新年，不料大批夕兽入侵中洲，快去消灭夕兽保卫家园吧！
【三羊开泰】吉羊瑞雪 : 瑞雪兆丰年，天墉城现已变成了一片银装素裹之景象，想不想叫上三五个好友一起把#R天墉城#n的#Y雪球#n堆成#Y雪人#n呢？堆好后还有机会获得意想不到的惊喜。活动所有双倍、三倍奖励均无效。
变异宠天技灵现 : 如今强者如云，天骄如雨，灵兽异人受命助道友一把，让变异宠物如虎添翼，可不容错过此次绝佳机会。
【情人节】月老很忙 : 情人节是一个关于爱、浪漫以及玫瑰花、巧克力的节日。
【元宵节】元宵灯会 : 正月是农历的元月，古人称夜为宵，所以称正月十五为元宵节。元宵节是一年中第一个月圆之夜，也是一元复始，大地回春的夜晚，人们对此加以庆祝，也是庆贺新春的延续。
【清明节】踏青摘柳 : 清明时节，正是户外踏青的好时候。道友可前往#Y桃柳林#n欣赏春景，顺便帮#Y活动大使#n带些驱邪的柳条回来。
【清明节】插柳驱邪 : 清明节到了，中洲城镇游荡着孤魂野鬼，活动大使给众道友分发了驱邪柳条，号召众人一起驱逐鬼魂。
【青年节】成年考验 : 你来到中洲世界已有一段时间了，道家长辈现已在天墉城摆下考验，检查你是否已经成年，快去接受考验吧，挑战成功的人可以获得丰厚的奖励。
【植树节】养成仙树 : 又是一年植树节，让我们拿起工具，到户外种下仙树，点缀我们的中洲世界吧。
精卫填海・精卫夺宝 : 介绍中国经典神话精卫填海的故事。
精卫填海・集结众神 : 介绍中国经典神话精卫填海的故事。
精卫填海・绝地反击 : 介绍中国经典神话精卫填海的故事。
精卫填海・炎谷救父 : 介绍中国经典神话精卫填海的故事。
精卫填海・炎帝除魔 : 介绍中国经典神话精卫填海的故事。
斗宠挑战赛 : 中洲大地珍奇异兽万千，谁才是斗宠之王的拥有者？！
精卫填海・冥海之战 : 介绍中国经典神话精卫填海的故事。
精卫填海・初战金乌 : 介绍中国经典神话精卫填海的故事。
精卫填海・决战金乌 : 介绍中国经典神话精卫填海的故事。
精卫填海・精卫寻父 : 介绍中国经典神话精卫填海的故事。
精卫填海・灵石护体 : 介绍中国经典神话精卫填海的故事。
【劳动节】百姓献礼 : 由于你常年来的帮助，天墉城的居民对你十分感谢，特准备了大量的礼物，感谢你的付出。
【劳动节】天墉城大扫除 : 天墉城出现了很多邋遢鬼，对天墉城的环境带来了很恶劣的影响，快去驱除它们吧。
【九周年】九五之尊 : 《问道》九周年活动庆典正在进行中，玩家可直接使用#R九周年蛋糕#n获得丰厚奖励！也可以与#R老酒#n在九五之尊界面制作并直接提交#R九周年酒香蛋糕#n，提交后可获得丰厚奖励！
【九周年】九九归一 : 《问道》九周年庆典期间，集齐99块腓腓灵魂石和9块灵魂融合石就可以到#P活动大使#P处召唤#R变异#n纪念宠：#R腓腓#n哦！
【九周年】九洲同庆 : 为了庆贺《问道》九周年，龙之九子都来到#Z天墉城#Z派发#R九周年红包#n！
【九周年】九子登科 : #R龙之九子#n特来#Z天墉城(248,202)#Z附近与道友们共贺《问道》九周年。
【九周年】九子送福 : 【九周年】庆典期间，#R龙之九子#n降临天墉城，九子们调皮的躲在天墉城居民当中。
【九周年】九天揽月 : 中洲大陆各地的居民们都在庆祝《问道》九周年，传说中的龙之九子也下凡中洲庆周年！
【九周年】狐生九尾 : #Z官道北#Z的灵狐经过千百年的修炼，竟生九尾而成妖！
【跨服玩法】登上九重天 : 登上九重天，位列仙中仙；九重天是仙家至高荣誉的象征，然而这份平静被突然出现的血月魔族打破了。
为苍生灭魔 : 血月魔族已经入侵了九重天，为了天下苍生消灭这些妖魔刻不容缓。
团队副本 : 天墉城外战云密布，杨总兵镇守城门，众道友能否协助守军，击破敌人布下的阵法，救百姓于水火？速通过#P金灵尊圣#P处传送至战场，加入这场战斗吧！
【昆仑神镜】神农尝百草 : 昆仑神镜，穿越时空！你被#P昆仑镜仙#P送到了上古洪荒时代，快去完成他的托付吧。
【昆仑神镜】女娲补苍天 : #P昆仑镜仙#P带你穿越回洪荒时代，亲眼目睹女娲补天的盛举。
【昆仑神镜】伏羲创八卦 : 昆仑神镜，穿越时空！你被#P昆仑镜仙#P送到了上古洪荒时代，快去完成他的托付吧。
【昆仑神镜】燧人取圣火 : #P昆仑镜仙#P带你穿越回洪荒时代，亲眼目睹燧人取火的盛举。
【暑假】护身宝盒 : 曾经大闹过天宫的孙行者来到天墉城了，听说他有一个护身宝盒要送给别人，你想要吗？
【暑假】抓捕仙人 : 曾经大闹过天宫的孙行者来到天墉城了，他要求你找到抓住出没在天墉城的散仙，你会帮助他吗？#r活动双倍、三倍、全局双倍无效。
【暑假】乱斗NPC : 曾经大闹过天宫的孙行者来到天墉城了，他要你找#R天墉城#n的#R某个NPC#n报仇，你会选择哪些NPC呢？
【暑假】大闹天墉 : 大闹天宫的孙行者来到了天墉城，五百年前被压在五指山下受尽屈辱，如今得道成佛仍不改豪放不羁的性格，邀请众人前来天墉捣乱！
【暑假】捣乱天墉城 : 曾经大闹过天宫的孙行者来到天墉城了，他要求你协助他在天墉城捣乱，你是接受还是拒绝呢？
【暑假】营救妖猴 : 曾经大闹过天宫的孙行者来到天墉城了，他委托你营救他的猴子猴孙，你能帮助他吗？
【暑假】火眼金睛 : 孙行者在天墉城捣乱，各路妖魔假借其名义乔装成天墉城居民在城内招摇撞骗。大圣发布捉妖令，凡愿意捉妖者都可获得其绝学“火眼金睛”。
【暑假】衙门闹事 : 孙行者来到天墉城捣乱，总督衙门派人来阻挠。大圣想了个办法让他们自顾不得，免得影响捣乱大计。
突破境界 : 自从南天门试炼后，筋骨之间总有一股寒流蠢蠢欲动，是福是祸？谁又知晓。
【端午节】赛龙舟 : 五月五，赛龙舟，品粽子，闹端午。
【活动】仙宠下凡 : 天庭的仙宠们带着一身的宝贝来到了中洲大地，它们个个身怀绝技，只要道友们能打败它们，就有机会获得仙宠的馈赠。
【中元节】驱鬼除邪 : 中元节到来之际，地府鬼门大开，许多恶鬼趁机在中洲大陆为非作歹，#P活动大使#P诚邀道友驱鬼除邪，保卫中洲。
【儿童节】娘娘赐福 : 为了使中洲的娃娃们远离饥饿和痛苦，送子娘娘特意来到天墉城为天下娃娃赐福，快带上你家聪明伶俐的娃儿去见活动大使吧。
送子娘娘之高级赐福 : 送子娘娘对你的娃娃疼爱有加，特给予了高级赐福，保护你的娃娃平安。
【儿童节】童心未泯 : 在这欢乐的节日里，小朋友们都跑出屋子愉快的玩耍。他们都在哪里玩呢？快去找#P活动大使#P问问吧！
【双节同庆】普天欢庆 : 值此中秋和国庆双节同庆之际，#Z天墉城#Z的居民普天欢庆！
【双节同庆】全民挑战 : #R道王高徒#n特来#Z天墉城(248,202)#Z附近与道友们共贺中秋、国庆！
【双节同庆】玉兔捣乱 : 中秋节期间，调皮的玉兔们下凡到天墉城捣乱！
【双节同庆】种植桂树 : 值此花好月圆、举国同庆之际，月兔们希望能够从中洲移植一些桂树美化月宫，帮助它们的人将获得丰厚的报酬。快去问问#P活动大使#P如何种植月宫桂树吧！
【双节同庆】天狗吞月 : 中秋节期间，天狗大军竟然发动了大规模入侵，妄想吞食明月，扰乱中秋月圆之夜！
【双节同庆】盛世繁华 : 《问道》双节同庆活动庆典正在进行中，玩家可直接使用#R双节庆蛋糕#n获得丰厚奖励！也可以与#R老酒#n在盛世繁华界面制作并直接提交#R双节庆酒香蛋糕#n，提交后可获得丰厚奖励！
【双节同庆】嫦娥祈福 : 值此花好月圆、举国同庆之际，天墉城居民们纷纷带上祈福物品前往风月谷摆设香案，向善良的嫦娥祈求吉祥平安。可恶的#Y蓬蒙恶人#n在半道上想强占祈福物品，道友们是否愿意帮助居民们运送祈福物品呢？
【双节同庆】巅峰盛典 : 《问道》双节同庆活动庆典正在进行中，中秋节当天和国庆节当天晚上将举行#R巅峰盛典#n活动！
【双节同庆】中秋博饼 : 博饼是中秋节时的一种大众娱乐活动，用六粒骰子投掷结果组合来决定参与者的奖品。今年你不仅可以挑战#Y博饼状元#n，还可以和别的玩家比比手气！
【守护和平】中华崛起 : 犯我中华者，虽远必诛！在中洲世界的海边来了很多倭寇，快去击败他们，扬我国威！
西巡令 : 凡接此令者，将身负重任。期间历尽千难万险终可修成正果，赢取丰厚奖励。
五雷令 : 消耗耐久度可直接领取#Y助人为乐、八仙梦境、昆仑神镜、帮派日常挑战#n等任务的奖励(#R需要每周先完成至少一次任务，才可使用五雷令#n)。
【六星成就】百科全书 : 恭喜你，受文曲星提点被选中为#R百科全书候选人#n。想成为真正令人敬仰的#R百科全书#n吗？那就快快行动吧！
【六星成就】神农尝百草 : 未曾想不经意间挖到的草药竟然是百年一遇的药精，据说吸取一定数量的药精便可将其转换为上等神药，助自己早日修为圆满。不知此话是真是假，既然今日巧遇，何不一试呢？
别人家的配偶 : 别人家的总是好的，不知道你能否找到一位这样的人中龙凤，真正体会下别人家的好呢？
娃娃训练营 : 每天带着娃娃在#P乐豆豆#P开办的训练营中训练#R20分钟#n，假以时日娃娃的作战能力定当突飞猛进。
召集令 : #Y太上老君#n下达任务召集令，只要在特定的线路完成指定的任务就可以获得额外的数值奖励加成。
【活动】幻兽试炼 : 幻兽秘卷中封印着各种幻兽。听说只要通过了它们的考验，便能得到丰厚的奖励。
【教师节】展示实力 : 一年一度的教师节又到来了，五系门派的师傅们派出了师兄弟们来到天墉城考验你的实力，战胜他们向师傅展示你的实力，为师傅献上教师节的礼物吧。
【七夕节】鹊桥相聚 : 今日云骈渡鹊桥，应非脉脉与迢迢。中洲大地的喜鹊受到魔王的要挟，都不敢前去风月谷筑鹊桥。望众道友救出喜鹊，共筑鹊桥，让有情人终成眷属。#r单条线击杀妖魔的总次数到达一定值时，将会引出#Y魔王#n，击败它可获得丰厚的道具奖励。#Y魔王#n身上还带着许多#R魔王宝箱#n，当它被击败后将会撒在地图上。
【守护和平】大阅兵 : 欢庆#R反法西斯战争胜利70周年#n之际，壮我国威，保卫和平，特举办此次阅兵式。期间或许还能看到我们自己的雄姿。瞧，一列列有型的方阵队即将向我们走来……
【指引】了解相性的作用 : 去见见门派童子，了解相性的作用。
仙宠鉴宝 : 仙宠可助你获得天技秘笈宝箱中的宝贝。
天狗吞月・消失之月 : 月亮突然消失在夜空中，百姓谣传“天狗”吞食了月亮，真相到底是什么呢？
天狗吞月・天狗传说 : 月亮突然消失在夜空中，百姓谣传“天狗”吞食了月亮，真相到底是什么呢？
天狗吞月・灵兽天狗 : 月亮突然消失在夜空中，百姓谣传“天狗”吞食了月亮，真相到底是什么呢？
天狗吞月・寻找天狗 : 月亮突然消失在夜空中，百姓谣传“天狗”吞食了月亮，真相到底是什么呢？
天狗吞月・线索初现 : 月亮突然消失在夜空中，百姓谣传“天狗”吞食了月亮，真相到底是什么呢？
天狗吞月・天狗身世 : 月亮突然消失在夜空中，百姓谣传“天狗”吞食了月亮，真相到底是什么呢？
天狗吞月・修炼神功 : 月亮突然消失在夜空中，百姓谣传“天狗”吞食了月亮，真相到底是什么呢？
天狗吞月・复仇之路 : 月亮突然消失在夜空中，百姓谣传“天狗”吞食了月亮，真相到底是什么呢？
天狗吞月・株连之罪 : 月亮突然消失在夜空中，百姓谣传“天狗”吞食了月亮，真相到底是什么呢？
天狗吞月・灵魂不灭 : 月亮突然消失在夜空中，百姓谣传“天狗”吞食了月亮，真相到底是什么呢？
【活动】幻兽试炼 : 幻兽秘卷中封印着各种幻兽。听说只要通过了它们的考验，便能得到丰厚的奖励。
【教师节】展示实力 : 一年一度的教师节又到来了，五系门派的师傅们派出了师兄弟们来到天墉城考验你的实力，战胜他们向师傅展示你的实力，为师傅献上教师节的礼物吧。
【七夕节】鹊桥相聚 : 今日云骈渡鹊桥，应非脉脉与迢迢。中洲大地的喜鹊受到魔王的要挟，都不敢前去风月谷筑鹊桥。望众道友救出喜鹊，共筑鹊桥，让有情人终成眷属。#r单条线击杀妖魔的总次数到达一定值时，将会引出#Y魔王#n，击败它可获得丰厚的道具奖励。#Y魔王#n身上还带着许多#R魔王宝箱#n，当它被击败后将会撒在地图上。
【守护和平】大阅兵 : 欢庆#R反法西斯战争胜利70周年#n之际，壮我国威，保卫和平，特举办此次阅兵式。期间或许还能看到我们自己的雄姿。瞧，一列列有型的方阵队即将向我们走来……
【指引】了解相性的作用 : 去见见门派童子，了解相性的作用。
300环连环 : 300环连环任务为单人的获取经验或者道行的任务，每周可以完成一次经验模式或道行模式，一共300环。每一环小任务都可以获得数值奖励和任务积分，同时还有几率获得#R金钱#n。#R任务积分#n可以在#P问道活动大使#P处兑换#R商城道具#n。完成所有任务后可以在#P问道活动大使#P处抽取一次神秘大礼，下一周周一的0点可以重新领取任务。
【感恩节】火鸡快跑 : 感恩节期间，火鸡大军竟然发动了大规模反抗，快去制止它们这种疯狂的行为吧！
【重阳节】壮志豪饮 : 重阳将至，饮一杯桂花酒，有助于大家驱邪消灾。如今#Z东海渔村#Z、#Z无名小镇#Z正在遭受一群邪魔妖道的咒语侵袭，各位仁人志士快去解救百姓，还大家一个和谐安宁的重阳节。成功解救百姓，还有机会触发与#Y邪咒灵王#n、#Y邪咒灵魔#n的战斗，胜利后还有机会获得意想不到的惊喜。
【重阳节】祭天祈福 : 昨日登高罢，今朝再举觞。一年一度的重阳之际，请跟随#P祭天使者|天墉城(227，134)#P静心为心中那片净土祈福，祷告吧！
【欢度圣诞】圣诞大礼 : 圣诞佳节，挂满圣诞礼物的圣诞树已经到达天墉城，大家快去领取圣诞节礼物吧！
【欢度圣诞】打雪仗 : 圣诞佳节，调皮的雪人和捣乱的驯鹿在#Z天墉城#Z打雪仗，我们也去玩玩吧！
【光棍节】齐心诛魔 : 宁静的天墉城马上就要被前来突袭的妖魔打破了，你能阻止这场浩劫的发生吗？
【元旦】百花争艳 : 元旦活动期间，花仙子们下凡到天墉城，找到她们的人将获得祝福。
【元旦】夺宝大战 : 元旦期间，财神时不时在中洲各地洒下大量宝箱等待有缘人开启，但是妖魔和土匪们不知道从哪里得到了这个消息，一场夺宝大战就此展开！
【万圣节】狂欢舞会 : 万圣节疯狂派对，让我们一起舞狂欢吧！
撕铭牌大战 : 修道之人，进入指定战场后就可附着铭牌元魄！
试道大会奖励 : 此任务作为领取试道大会奖励的凭证
【寒假】哪吒战群雄 : 小哪吒在#Z天墉城#Z设下擂台，各位道友可前往比试，45分钟内挑战层数最高的队伍可获得丰厚的道具奖励。
【寒假】哪吒护东海 : 东海之上，邪气弥漫，虾兵蟹将受妖魔蛊惑，正在#Z东海渔村#Z作乱，#Y哪吒#n已前去捉拿释放邪气的魔王，请各位道友帮忙打退在渔村中作乱的虾兵蟹将。
【寒假】哪吒送祝福 : 寒假到了，小哪吒来送祝福。
【寒假】哪吒闹天墉 : 太乙真人要闭关修炼，无暇顾及他的小徒儿哪吒，却又担心无人看管的哪吒惹出祸端来，适逢寒假来临于是把哪吒送到天墉城，请众道友帮忙照看。
【寒假】哪吒忙寻宝 : 天墉城来了一伙窃贼，把哪吒的法宝乾坤圈给偷走了，大家快帮助小哪吒找回法宝。
【寒假】哪吒品美食 : 小哪吒来到天墉城做客，活动大使请道友们帮忙烹制中洲美食，招待远道而来的客人。
【寒假】烹制佳肴 : 天墉城的居民们各个都是烹饪好手，道友可向他们请教请教。
【超神之战】精英选拔 : #Z天墉城#Z出现一批批#Y恐怖恶魔#n，快将其击杀成为万众瞩目的英雄吧！在#P活动大使#P处购买#R超神符咒卡#n对自己进行变身，进入战场后将有神秘老者相助，同时还可以获得更加丰厚的奖励！#R（拥有超神符咒效果的玩家只能单人进行精英选拔活动）#n
实物大奖 : 您已申请领取光宇华夏赠送的实物大奖，我们将尽快将其送达。
实物大奖订单 : 您申请领取的实物大奖因#R信息有误#n而无法送达，需重新填写订单。
撤销实物大奖订单 : 您申请领取的实物大奖因#R地区过于偏远#n而无法送达，我们将退还您使用的#R实物大奖#n道具。
得道九重天 : 前往#Z九重天天宫#Z寻访四方神君，与之切磋仙法以助修行！
得道九重天（队长） : 前往#Z九重天天宫#Z寻访四方神君，与之切磋仙法以助修行！
【勤学苦练】抽取奖励 : 由于你在本月努力付出，师傅为你准备了丰厚的奖励，快去看看吧。
【勤学苦练】师门试炼 : 由于你在本月努力付出，师傅为你准备了师门的试炼，成功完成试炼可获得丰厚的数值奖励，快去看看吧。
【劳动节】争当劳模 : 劳动节期间#P活动大使#P受中洲劳模的委托，在#Z天墉城#Z发布劳动任务，大家快去帮忙吧！
【劳动节】劳模投票 : 劳动节到了，快来#P活动大使#P处参加#R【劳动节】劳模投票#n活动吧，给你喜爱的劳模投票，只要投票就可以获得奖励！
【愚人节】愚人欢乐逗 : 活动期间，向#Y余仁杰#n或#Y窦霓婉#n发起挑战并获胜即可获得奖励以及愚人积分，挑战评星越高获得的奖励和积分越多。积分可以在#P活动大使#P处兑换数值奖励，同时有机会获得道具奖励。
悟道修仙 : 拥有该任务的玩家使用商城道具#R修为丹#n时，有几率获得额外的修为值奖励。
【春节】元灵挑战 : 值此新年之际，颛顼给全中洲玩家送福啦！颛顼派出了三只元灵迎接各道友的挑战。
【春节】金猴接春 : 《问道》春节活动庆典正在进行中，玩家可直接使用#R蜜桃#n获得丰厚奖励！也可以与#R水果卡#n在金猴接春界面制作并直接提交#R水蜜仙桃#n，提交后可获得丰厚奖励！
【春节】福至天墉 : 值此新年之际，颛顼给全中洲玩家送福啦！完成众多指定的系统获得经验或道行时，能额外获得颛顼赠送给你的勤奋奖励哟。
【春节】守岁得福 : 掌管日月星辰、时间流逝的尊神颛顼来到中洲大地啦，活动期间只要满足颛顼的种种要求就能获得丰收的奖励哟！
【春节】驱赶邪祟 : 值此新年之际，颛顼给全中洲玩家送福啦！中洲大陆上来了很多邪祟，想要吸取颛顼给予的福气，快快驱赶他们吧。
【春节】智斗功曹 : 掌管日月星辰、时间流逝的尊神颛顼来到中洲大地啦，活动期间只要满足颛顼的种种要求就能获得丰收的奖励哟！
【春节】祛病送福 : 值此新年之际，颛顼给全中洲玩家送福啦！请你快去给中洲各地的药铺送去福缘吧。
【元宵】元宵花灯 : 正月十五闹元宵，元宵节期间赏花灯是我国一项传统习俗，不过今年阴雨连绵，你能保证花灯元宵期间不熄灭吗？
【春节】吉羊回归 : 值此新年之际，颛顼给全中洲玩家送福啦！去年值守了一年的生肖吉羊将要回到天庭述职了，但却迷路在中洲大地，你能帮它们回到天庭吗？
【元宵】元宵字谜 : 正月十五闹元宵，元宵节期间猜字谜是我国一项传统习俗，你能收集到任务所需要的所有字谜吗？
【植树节】植树造林 : 时逢一年一度的植树节，#Y林场管理员#n号召大家一起植树造林，绿化中洲世界。
【植树节】除妖护林 : 时逢一年一度的植树节，#Y林场管理员#n号召大家一起植树造林，绿化中洲世界。
【清明节】超度亡魂 : 清明将至，#Z地府(51，103)#Z中的清明亡魂正等待大家的超度，成功将其超度可使其罪报减轻，往生极乐，同时也为自己记一份功德。大家快去超度清明亡魂吧！过程中有可能会触发与#Y鬼使神差#n的战斗，#R3#n人或#R3#n人以上组队还有机会触发与#Y阎王#n的战斗，胜利后均有机会获得意想不到的惊喜。
【情人节】真情告白 : 情人节到了，爱意怎么能憋在心里？如果爱，大声喊出来！
【情人节】约会大作战 : #Z风月谷#Z景色旖旎，气氛浪漫，堪称最佳约会地点。适逢情人节，这里更是炙手可热，许多情侣都选择在这里约会。
勇闯竞技场 : 全新开启的竞技场赛季，你能一路走到最后勇夺竞技场王者称号吗？
【十年问道】大圣考验 : #R大圣分身们#n特来#Z天墉城(248,202)#Z附近与道友们共贺《问道》十周年。
【十年问道】我是BOSS我做主 : 超级大BOSS组团前来#Z天墉城#Z妄想破坏《问道》十周年庆典！
【十年问道】大圣伏魔 : 正值天墉城《问道》十周年庆典期间热闹非凡，妖魔界的妖魔却不甘寂寞偷偷潜伏进天墉城意欲作乱，大圣得知此事，号召众道友为保天墉城安稳伏魔卫道。
【十年问道】周年寻宝 : 十周年庆典期间，参与超级藏宝图、藏宝箱、锦囊系统将额外更加丰厚的奖励！
全民刷道 : 全民刷道，谁与争锋，每周都可以免费刷道哦！#r#R注意：#n参加此活动后，进行刷道将只会获得#R道行#n、#R潜能#n、#R武学#n、#R修为（一星模式的降妖、伏魔任务无法获得）#n奖励。
【十年问道】大圣贺喜 : 参加#R【十年问道】系列活动#n或者在#R40级以上练功区打怪#n都有可能获得#R十周年蛋糕#n，右键点击即可使用，每天至多使用#R30块#n！
【十年问道】在线狂欢 : 十年问道，我们一同走过！在这意义非凡的日子里，我们一起庆祝、一起狂欢！只要累积在线时长并达成条件，即可获得丰厚奖励！
【十年问道】猜猜乐 : 今天我们邀请到了可爱的#P帅帅猴|天墉城(338,206)#P来跟大家一起欢度十周年庆典，他可是期待了很久要与天墉城里的小伙伴们好好地一起玩#R猜猜乐#n的哟！
绑定乾坤锁 : 通过绑定#R乾坤锁#n，可以很大程度的提高游戏帐号安全度，无论是#R实体乾坤锁#n还是#R手机乾坤锁#n都能随身携带，为玩家带来很大便捷。
返利抽奖 : 在充值返利活动中，充值额度达到#R5000、10000、50000、100000元宝#n领取返利奖励时分别可获得1个抽奖码，活动结束后系统将从抽奖码中选取玩家获得丰厚的坐骑、宠物、精魄等大奖。
【2016新服】签到送豪礼 : 当天完成以下所有的#R日常任务#n，就算完成当天签到！
【十年问道】猴哥快跑 : 十周年庆典期间特别开放#R猴哥快跑#n小游戏，轻松快跑，奖励多多！
【十年问道】十拿九稳 : 活动期间完成指定的#R十周年活动#n即可领取奖励，海量奖励，十拿九稳！
万万没想到 : 大圣分了你一些桃子，不知道味道如何啊！也许有【十周年】隐藏福利哦！
【指引】悟道系统 : 人物#R悟道系统#n已开启，领悟悟道境界即可增强人物能力。
【月活动】仙界宠物大逃亡 : 众仙驯养的仙元由于厌烦天上的生活而纷纷逃走，现已被天兵天将围堵至蝴蝶谷。快去帮忙把仙元送回仙界吧。
【月活动】夜游百鬼地 : 百鬼地内阴阳门封印不稳，每个月总有一拨鬼怪出来游荡意欲作乱，与天心道人一起消灭鬼怪，守卫人间！
古城王位争夺战 : 西域古城日益没落，大小王子都希望作为主宰者来振兴古城。一时之间古城的势力分成了两派，两派之间为了各自的拥护者冲突不断，同时又为了振兴古城的同一目标团结协作。
阵营大战 : 大王子阵营与小王子阵营之间的战斗，胜利方可获得丰厚奖励。
古城日常任务 : 古城日常任务，帮助本方阵营完成任务即可获得古城荣誉积分，每周古城荣誉积分多的阵营玩家可以获得丰厚的奖励。
修为周卡 : 购买修为周卡后，可在连续在一定时间内领取修为值。
【西域】中洲异客 : 在无名小镇突然出现的异族伤者，他的身份究竟是什么呢？
【西域】救死扶伤 : 你已来到了病情严重的西域古城，快展开对古城百姓的救治吧。
【西域】王位之争 : 大王子和小王子的王位之争已经弥漫着整个西域古城，气氛越来越紧张了。
【西域】真相大白 : 两个王子的王位之争似乎有一个幕后黑手在推波助澜、搅风搅雨，这背后的真相居然是……
【十年问道】光阴荏苒 : 光阴荏苒，岁月如梭！#R《问道》#n已经走过了十个年头！
【活动】利器行动 : 工欲善其事，必先利其器，活动期间，在鬼斧神工中进行装备打造、装备进阶、首饰加工、娃娃装备操作、法宝操作不用花费游戏币哦！#R注意：#n此活动只对绑定手机乾坤锁，或者绑定实体乾坤锁的玩家才有效。
【活动】宠物初长成 : 提升宠物能力是增强你的实力必不可少的过程，活动期间，在鬼斧神工中进行宠物养成不用花费游戏币哦！#R注意：#n此活动只对绑定手机乾坤锁，或者绑定实体乾坤锁的玩家才有效。
【端午节】祭奠先贤 : 每年的五月初五，是我国著名的节日“端午节”，我们有龙舟竞渡、吃粽子、喝雄黄酒的风俗；以此来纪念爱国先贤及诗人屈原。
储备奖励 : 若7天内有部分日常任务未完成，则今日可获得一定比率的储备奖励。
寻仙令 : 一名拥有#R老兵不死#n任务的玩家与一名没有#R老兵不死#n任务的玩家#R组队#n到#P问道缘大使#P处登记即可领取寻仙令任务！
【活动】九黎降妖 : #Z万佛窟#Z出现了许多妖兽，大家快去帮助#P九黎真人|万佛窟(112,45)#P封魔降妖，还可以获得#Y异兽熔炼#n的#R异兽躯干#n道具奖励。
全民升级 : 全民升级，谁与争锋，每周都可以免费参与升级任务哦！#r扣除耐久度参与升级任务将额外附加#R降妖除邪镜#n效果，另外战斗结束后#R免费恢复#n宠物忠诚度、人物和宠物的气血、法力。#r#R注意：#n参加此活动后，进行升级将不获得金钱和可转移道具奖励。
【儿童节】儿童节快乐 : 儿童节到了，小朋友们放假啦，带上糖果到#Z天墉城#Z去和他们一起欢度六一吧。
系统阻止 : 由于你的角色在游戏中涉嫌非法操作，已被#R系统阻止#n处理。GM已在核查信息，核查完毕后将进行相应的处理。
【暑假】斩妖护宝 : 西域运输商队与中洲居民们预定了一批丝绸、瓷器和药材，居民们已将货物储存在#Z天墉城#Z中。妖魔知晓此事后，打算潜入天墉城偷走这批货物，众道友帮助居民们打败妖魔守住货物。
【暑假】通关文牒 : 为了能让#Z天墉城#Z和#Z西域古城#Z的商人们更方便进行通商，#P活动大使#P准备了一些#R通关文牒#n，但丝绸之路重建工作很艰巨，没时间给他们送去，想烦请各位道友去#Z天墉城#Z帮活动大使派送通关文牒。
【暑假】镖行西域 : 由于西域的战事愈演愈烈，药品物资箱成为了抢手货，将药品物资箱从#Z天墉城#Z运到#Z西域古城#Z的#P西域商人#P处，可以获得很多奖励。注意：沙漠中的#R劫匪#n身上有许多宝物，千万别让他逃走了!
【暑假】扫匪除贼 : 如今通往西域的道路并不太平，盘踞于西域的马贼一直是个隐患，还请道友出手剿灭他们，为丝绸之路的重建保驾护航。
【中元节】除魔灭道 : 中元节到来，变身为鬼怪的玩家，组成了#R灭道阵营#n四处散播瘴气，其他玩家则组成了#R除魔阵营#n，你也赶快到#Z天墉城#Z#P活动大使#P加入其中一个阵营，参加大战吧！服务器将在活动结束时统计双方阵营人数，人数多的一方获胜，获胜的阵营将会获得额外的奖励哦！#r活动将在今天#R0#n点结束。
【暑假】幕后黑手 : 劫持货物的幕后黑手#R蜃楼魔尊#n终于现身，众道友快到#Z天墉城（221,131）#Z附近将其斩杀吧！
【暑假】重建丝绸之路 : 古时候西域和中洲本来有密切的往来，并建立起了一条繁荣丝绸之路，然而由于内乱，西域从此与中洲隔绝。如今天墉城和西域古城的居民们准备重建丝绸之路，你决定帮助他们。
【暑假】修复宝物 : 妖魔们试图潜入天墉城偷走西域商人预定的珍贵货物，被中洲众道友打败；可有一些货物在战斗中被损毁了，快帮忙协助修复这些货物吧。
【暑假】筹备物资 : 重建丝绸之路，需要筹备许多物资。如今人手紧缺，正需要各位道友大力相助。
押送镖银 : 帮助镖头护送镖银（本任务离队、暂离或转移队长时会消失）
【修炼】法宝共生之术 : 在#Y普华天尊#n处学习能够在战斗中携带、切换两个法宝的#Y法宝共生之术#n。
【抗战胜利纪念日】抵御外敌 : 近来中洲大陆近海出现了一些来历不明的人，怀疑是敌对外族的先锋部队，#P夏总兵#P因为人手不足，希望找些人去查探一下，找他了解一下详细情况吧！
【中秋】博饼盛典 : 博饼是闽南几百年来独有的中秋传统活动，如今天墉城也迎来了这一盛典。人们深信不疑，博中状元的人，一年当中运气肯定非常好，因为博饼活动里倾注了人们美好的感情寄托。
【中秋】仙界月饼 : 嫦娥仙子带来了仙界月饼的秘方特来分享给天墉城的人们，只要凑齐原料，就可以在嫦娥仙子的帮助下做出高大上的仙界月饼。
【中秋】守护嫦娥 : 中秋佳节如期而至，天墉城热闹非凡，原来是嫦娥仙子特意下凡与民同乐。然而似乎有妖魔对嫦娥仙子图谋不轨……
【教师节】献花谢师 : 生则谨养，死则敬祭，此尊师之道也。
【教师节】插花 : 插花是门高深的技艺，中洲大陆隐藏着许多插花高手，道友可请教他们插花之术。
阵营争霸 : #Y玄阴#n与#Y炎阳#n两大阵营之间自古以来争端不断，谁也无法称霸中洲。
【七夕】偷蛋妖魔 : 又是一年七夕，#Y比翼鸟#n为了牛郎织女搭起了鹊桥，却忽略照顾了它们的蛋，你能帮助它们吗？
【七夕】孵化仙蛋 : 你从妖魔手中夺回了比翼鸟的蛋，若协助帮忙孵化它，可得纪念宠或变异宠奖励哟。
【七夕】协助孵化仙蛋 : 协助其他玩家孵化比翼鸟的蛋，顺利孵化成功的话，可得纪念宠“小比翼鸟”。
绑定光宇游戏APP : 手机乾坤锁升级啦，更强大的帐号安全、管理工具尽在光宇游戏APP。
【国庆节】国庆摇摇乐 : 喜迎国庆节，#Z天墉城#Z的朋友们准备了丰厚的奖励在等着各位的到来。
【国庆节】降妖封神 : 国庆之际，镇妖塔中的疯狂的小妖又在跃跃欲试，终于冲出宝塔肆意侵害#Z天墉城#Z、#Z西域古城#Z中老百姓，众道友快将其降服吧！
【国庆节】勇往直前 : 鸿钧老祖派其座下宠物到#Z天墉城#Z与道友们共贺国庆节。
【国庆节】中洲赐福 : 参加#R【国庆节】系列活动#n或者在#R40级以上练功区打怪#n都有可能获得#R赐福蛋糕#n，右键点击即可使用，每天至多使用#R30块#n！
【国庆节】鬼怪出没 : 国庆佳节之际，正值秋高气爽之时，#R迷雾昆仑#n不时有些鬼怪出没，仙界遍寻能人异士捉拿这些鬼怪，并给予重赏，你准备好了吗？赶快前往#P活动大使#P处报名参加吧！#R注：鬼怪无法被当做宠物使用。#n
道法双修 : 在此状态下，完成降妖、伏魔、仙界通缉和飞仙渡邪任务可以额外获得#R法宝道法#n的奖励。
【感恩节】筹备大餐 : 说到感恩节，那肯定少不了一顿美味的火鸡大餐啦！#Z天墉城#Z的#P活动大使#P为了筹备大餐所需要的食材，正在寻求道友你的帮助呢！
工资荣誉 : 每月拥有足够的荣誉值和在线时长，1~5号可以至#P善财童子#P处兑换相应工资。
洞府挑战 : 中洲异府，别有洞天。
技能觉醒 : 技能觉醒符印乃元始天尊心爱之物，可绽放华光，火焰夺目。用来替换角色使用师门技能与力破千钧技能时效果。
【时辰】至尊十二生肖 : 听说不同时辰会有不同的生肖出现，想抓住调皮的十二生肖可不是一件容易的事。
【时辰】十二生肖 : 听说不同时辰会有不同的生肖出现，想抓住调皮的十二生肖可不是一件容易的事。
【时辰】五行考验 : 每次运势改变时有几率出现五行之神的考验，接受考验后五行之神化身将现身中洲。不同时辰可能出现的五行之神化身不同，完成考验的人能得到五行之神的馈赠。
【圣诞节】尽情狂欢 : 圣诞之际，#Y逗比乐小妖#n又在跃跃欲试，快去#Z天墉城#Z、#Z无名小镇#Z将其降服吧！
宠物训练营 : 每天带着宠物在#P宠物大使#P开办的宠物训练营中和其他训练师切磋，宠物必然进步神速。
【万圣节】变身大作战 : 【万圣节】变身大作战，让我们一起打败恶魔，帮天墉城的NPC变回原来的形象吧！
【重阳节】敬老祈福 : 农历九月初九日是我国的传统节日“重阳节”，其节日意义是敬祖、敬老、感恩。在这特殊的一天，天墉城会发生什么呢？
【活动】积分许愿 : 活动时间内，在#R积分许愿#n界面中用#R金元宝#n可以兑换#R许愿积分#n和#R银元宝#n。或者在游戏中每消费#R100金元宝#n，也可以获得#R1点许愿积分#n。
速赛竞技场 : 以本月道行进行角逐的速赛竞技场，你能否夺得冠军？
每周刷道时间 : 每人每周最多可刷道#R70#n小时，进行刷道任务之前需先领取刷道时间，所有刷道任务共享该时间。
呼风唤雨 : 呼风唤雨符中的强大力量暂时改变了天气，当真是翻手为云覆手为雨的手段啊！
【光棍节】光棍专享福利 : 光棍没什么不好，你还有自由自在，你还有无限的可能，你还可以玩《问道》......总之光棍节《问道》送温暖，光棍不哭，《问道》陪你。
【光棍节】福利彩票 : 光棍节如期而至，天墉城特开启一期光棍节彩票以慰广大光棍，祝君好运。
